,PCRatio,VolumeCall,VolumePut,VolumeTotal,OpenInterestCall,OpenInterestPut,OpenInterestTotal
2003-10-17,0.46,1017225,463135,1480360,0,0,0
2003-10-21,0.59,648197,380941,1029138,0,0,0
2003-10-22,0.77,541154,415498,956652,0,0,0
2003-10-23,0.72,493194,354797,847991,0,0,0
2003-10-24,0.79,567785,447421,1015206,0,0,0
2003-10-27,0.51,435215,223098,658313,0,0,0
2003-10-28,0.66,563950,374757,938707,0,0,0
2003-10-29,0.53,693158,364516,1057674,0,0,0
2003-10-30,0.7,627894,439451,1067345,0,0,0
2003-10-31,1.03,491689,504173,995862,0,0,0
2003-11-03,0.47,569931,268312,838243,0,0,0
2003-11-04,0.49,595255,294407,889662,0,0,0
2003-11-05,0.55,551267,301209,852476,0,0,0
2003-11-06,0.61,548140,336513,884653,0,0,0
2003-11-07,0.61,643147,394891,1038038,0,0,0
2003-11-10,0.78,432969,339129,772098,0,0,0
2003-11-11,0.73,447950,326768,774718,0,0,0
2003-11-12,0.68,592174,403860,996034,0,0,0
2003-11-13,0.63,609893,383694,993587,0,0,0
2003-11-14,0.55,662739,361347,1024086,0,0,0
2003-11-17,0.65,658441,427919,1086360,0,0,0
2003-11-18,0.63,568928,355730,924658,0,0,0
2003-11-19,0.77,551508,423986,975494,0,0,0
2003-11-20,0.65,562395,364840,927235,0,0,0
2003-11-21,0.66,693747,461316,1155063,0,0,0
2003-11-24,0.51,630412,320424,950836,0,0,0
2003-11-25,0.48,546189,263896,810085,0,0,0
2003-11-26,0.54,462159,251258,713417,0,0,0
2003-11-28,0.55,218810,121315,340125,0,0,0
2003-12-01,0.54,597095,324169,921264,0,0,0
2003-12-02,0.52,601278,314983,916261,0,0,0
2003-12-03,0.74,608963,453120,1062083,0,0,0
2003-12-04,0.57,584895,330837,915732,0,0,0
2003-12-05,0.68,494881,335345,830226,0,0,0
2003-12-08,0.71,458933,325923,784856,0,0,0
2003-12-09,0.56,611586,340208,951794,0,0,0
2003-12-10,0.69,625605,430133,1055738,0,0,0
2003-12-11,0.5,589907,297193,887100,0,0,0
2003-12-12,0.5,511771,257406,769177,0,0,0
2003-12-15,0.54,607936,328286,936222,0,0,0
2003-12-16,0.5,634957,315241,950198,0,0,0
2003-12-17,0.49,604679,294453,899132,0,0,0
2003-12-18,0.51,665543,341417,1006960,0,0,0
2003-12-19,0.61,791236,481898,1273134,0,0,0
2003-12-22,0.61,553240,337362,890602,0,0,0
2003-12-23,0.58,489783,282026,771809,0,0,0
2003-12-24,0.5,249030,123777,372807,0,0,0
2003-12-26,0.38,225065,84573,309638,0,0,0
2003-12-29,0.38,565058,213912,778970,0,0,0
2003-12-30,0.37,557304,204816,762120,0,0,0
2003-12-31,0.95,541039,511781,1052820,0,0,0
2004-01-02,0.53,545682,288114,833796,0,0,0
2004-01-05,0.53,869787,458669,1328456,0,0,0
2004-01-06,0.4,872664,347760,1220424,0,0,0
2004-01-07,0.51,802874,408677,1211551,0,0,0
2004-01-08,0.52,970355,500507,1470862,0,0,0
2004-01-09,0.45,942691,420871,1363562,0,0,0
2004-01-12,0.61,744167,457457,1201624,0,0,0
2004-01-13,0.48,883197,423555,1306752,0,0,0
2004-01-14,0.52,843879,442894,1286773,0,0,0
2004-01-15,0.46,1148119,525641,1673760,0,0,0
2004-01-16,0.35,1532818,537984,2070802,0,0,0
2004-01-20,0.52,994208,513167,1507375,0,0,0
2004-01-21,0.47,882847,415059,1297906,0,0,0
2004-01-22,0.74,783191,581852,1365043,0,0,0
2004-01-23,0.6,764989,456491,1221480,0,0,0
2004-01-26,0.47,628069,296878,924947,0,0,0
2004-01-27,0.64,653867,421537,1075404,0,0,0
2004-01-28,0.66,759350,503525,1262875,0,0,0
2004-01-29,0.64,836300,538960,1375260,0,0,0
2004-01-30,0.71,580051,409448,989499,0,0,0
2004-02-02,0.61,655778,401302,1057080,0,0,0
2004-02-03,0.58,655186,379015,1034201,0,0,0
2004-02-04,0.64,705234,448458,1153692,0,0,0
2004-02-05,0.66,654226,434512,1088738,0,0,0
2004-02-06,0.46,779861,360398,1140259,0,0,0
2004-02-09,0.59,587594,348886,936480,0,0,0
2004-02-10,0.62,608761,377773,986534,0,0,0
2004-02-11,0.56,732913,409807,1142720,0,0,0
2004-02-12,0.43,820594,354644,1175238,0,0,0
2004-02-13,0.59,632241,370129,1002370,0,0,0
2004-02-17,0.81,691467,561932,1253399,0,0,0
2004-02-18,0.64,718617,462347,1180964,0,0,0
2004-02-19,0.59,953805,560338,1514143,0,0,0
2004-02-20,0.66,1046201,689385,1735586,0,0,0
2004-02-23,0.47,782625,370123,1152748,0,0,0
2004-02-24,0.65,708377,462156,1170533,0,0,0
2004-02-25,0.62,621845,385431,1007276,0,0,0
2004-02-26,0.52,607116,316163,923279,0,0,0
2004-02-27,0.59,528027,313869,841896,0,0,0
2004-03-01,0.55,360769,199757,560526,0,0,0
2004-03-02,0.51,597318,305438,902756,0,0,0
2004-03-03,0.6,508197,304249,812446,0,0,0
2004-03-04,0.6,547185,326334,873519,0,0,0
2004-03-05,0.61,556020,338207,894227,0,0,0
2004-03-08,0.66,634998,417338,1052336,0,0,0
2004-03-09,0.86,637026,545759,1182785,0,0,0
2004-03-10,0.72,695671,504032,1199703,0,0,0
2004-03-11,0.96,675246,645835,1321081,0,0,0
2004-03-12,0.82,563698,463767,1027465,0,0,0
2004-03-15,0.85,520912,440227,961139,0,0,0
2004-03-16,0.93,543232,504419,1047651,0,0,0
2004-03-17,0.67,721088,482881,1203969,0,0,0
2004-03-18,0.65,607071,393536,1000607,0,0,0
2004-03-19,0.89,677758,599883,1277641,0,0,0
2004-03-22,0.74,659464,489962,1149426,0,0,0
2004-03-23,0.57,641833,366452,1008285,0,0,0
2004-03-24,0.73,543336,395211,938547,0,0,0
2004-03-25,0.6,816089,488795,1304884,0,0,0
2004-03-26,0.62,482828,300893,783721,0,0,0
2004-03-29,0.47,582658,275790,858448,0,0,0
2004-03-30,0.46,581353,267971,849324,0,0,0
2004-03-31,1.1,503749,553298,1057047,0,0,0
2004-04-01,0.47,676577,317796,994373,0,0,0
2004-04-02,0.53,994736,531671,1526407,0,0,0
2004-04-05,0.49,795684,389406,1185090,0,0,0
2004-04-06,0.69,728128,505325,1233453,0,0,0
2004-04-07,0.54,601191,323103,924294,0,0,0
2004-04-08,0.59,576071,338140,914211,0,0,0
2004-04-12,0.57,518155,296210,814365,0,0,0
2004-04-13,0.77,659012,510532,1169544,0,0,0
2004-04-14,0.6,627311,379075,1006386,0,0,0
2004-04-15,0.67,757064,506667,1263731,0,0,0
2004-04-16,0.61,1043624,637847,1681471,0,0,0
2004-04-19,0.56,670596,378865,1049461,0,0,0
2004-04-20,0.69,699494,482043,1181537,0,0,0
2004-04-21,0.54,641861,346031,987892,0,0,0
2004-04-22,0.54,800523,430109,1230632,0,0,0
2004-04-23,0.63,649924,409471,1059395,0,0,0
2004-04-26,0.54,545893,292805,838698,0,0,0
2004-04-27,0.57,772474,441571,1214045,0,0,0
2004-04-28,0.65,702768,453822,1156590,0,0,0
2004-04-29,0.77,664197,513577,1177774,0,0,0
2004-04-30,0.95,681410,649293,1330703,0,0,0
2004-05-03,0.64,503819,320393,824212,0,0,0
2004-05-04,0.5,583332,291348,874680,0,0,0
2004-05-05,0.66,438233,288426,726659,0,0,0
2004-05-06,0.97,398820,385067,783887,0,0,0
2004-05-07,0.79,529005,418012,947017,0,0,0
2004-05-10,0.87,640887,560050,1200937,0,0,0
2004-05-11,0.92,603030,556511,1159541,0,0,0
2004-05-12,0.94,592635,557502,1150137,0,0,0
2004-05-13,0.77,538985,417575,956560,0,0,0
2004-05-14,0.82,398858,326891,725749,0,0,0
2004-05-17,0.96,441661,425646,867307,0,0,0
2004-05-18,0.75,561884,423685,985569,0,0,0
2004-05-19,0.56,721918,405761,1127679,0,0,0
2004-05-20,1.02,432627,440072,872699,0,0,0
2004-05-21,0.81,661326,534158,1195484,0,0,0
2004-05-24,0.62,558321,347209,905530,0,0,0
2004-05-25,0.69,648742,448555,1097297,0,0,0
2004-05-26,0.73,519789,381312,901101,0,0,0
2004-05-27,0.63,512473,320999,833472,0,0,0
2004-05-28,0.7,325223,228402,553625,0,0,0
2004-06-01,0.73,422150,306293,728443,0,0,0
2004-06-02,0.64,462504,296992,759496,0,0,0
2004-06-03,1.01,407717,409788,817505,0,0,0
2004-06-04,0.83,424059,350459,774518,0,0,0
2004-06-07,0.63,522695,327387,850082,0,0,0
2004-06-08,0.66,457046,300707,757753,0,0,0
2004-06-09,0.73,449561,327720,777281,0,0,0
2004-06-10,1.01,364599,367379,731978,0,0,0
2004-06-14,1.19,363741,433002,796743,0,0,0
2004-06-15,0.63,534309,337034,871343,0,0,0
2004-06-16,0.53,493559,260257,753816,0,0,0
2004-06-17,0.63,604920,383811,988731,0,0,0
2004-06-18,0.6,907770,543536,1451306,0,0,0
2004-06-21,0.63,569441,360845,930286,0,0,0
2004-06-22,0.69,623543,431825,1055368,0,0,0
2004-06-23,0.57,620417,356186,976603,0,0,0
2004-06-24,0.49,698962,341775,1040737,0,0,0
2004-06-25,0.57,477164,272300,749464,0,0,0
2004-06-28,0.51,735475,374297,1109772,0,0,0
2004-06-29,0.77,500659,386514,887173,0,0,0
2004-06-30,0.73,546725,400925,947650,0,0,0
2004-07-01,0.74,576755,429000,1005755,0,0,0
2004-07-02,0.71,459413,325758,785171,0,0,0
2004-07-06,1.0,499103,499144,998247,0,0,0
2004-07-07,0.91,480035,434571,914606,0,0,0
2004-07-08,0.82,580709,477272,1057981,0,0,0
2004-07-09,0.67,468279,315317,783596,0,0,0
2004-07-12,0.91,405944,368269,774213,0,0,0
2004-07-13,0.63,515012,326622,841634,0,0,0
2004-07-14,0.76,700593,533493,1234086,0,0,0
2004-07-15,0.62,708886,436307,1145193,0,0,0
2004-07-16,0.93,812201,758206,1570407,0,0,0
2004-07-19,0.58,685743,398101,1083844,0,0,0
2004-07-20,0.57,673255,386264,1059519,0,0,0
2004-07-21,0.6,706709,422885,1129594,0,0,0
2004-07-22,0.71,639356,452128,1091484,0,0,0
2004-07-23,0.63,473413,297719,771132,0,0,0
2004-07-26,0.71,593357,422778,1016135,0,0,0
2004-07-27,0.55,570934,314997,885931,0,0,0
2004-07-28,0.55,635796,348299,984095,0,0,0
2004-07-29,0.56,547501,306108,853609,0,0,0
2004-07-30,0.53,464179,247812,711991,0,0,0
2004-08-02,0.66,392553,260392,652945,0,0,0
2004-08-03,0.54,396065,215231,611296,0,0,0
2004-08-04,0.72,403866,289736,693602,0,0,0
2004-08-05,0.7,462895,321930,784825,0,0,0
2004-08-06,1.28,535745,683184,1218929,0,0,0
2004-08-09,0.87,376267,326048,702315,0,0,0
2004-08-10,0.89,420364,375145,795509,0,0,0
2004-08-11,0.69,531373,365818,897191,0,0,0
2004-08-12,0.98,506274,495092,1001366,0,0,0
2004-08-13,0.75,418869,314266,733135,0,0,0
2004-08-16,0.67,465604,310574,776178,0,0,0
2004-08-17,0.69,537330,371034,908364,0,0,0
2004-08-18,0.82,571227,467918,1039145,0,0,0
2004-08-19,0.73,574296,421261,995557,0,0,0
2004-08-20,0.72,784646,566482,1351128,0,0,0
2004-08-23,0.72,537436,387781,925217,0,0,0
2004-08-24,0.59,475033,282587,757620,0,0,0
2004-08-25,0.6,495243,297051,792294,0,0,0
2004-08-26,0.7,441929,309162,751091,0,0,0
2004-08-27,0.73,362855,266495,629350,0,0,0
2004-08-30,0.69,358137,247203,605340,0,0,0
2004-08-31,0.59,376647,221352,597999,0,0,0
2004-09-01,0.77,336482,259033,595515,0,0,0
2004-09-02,0.72,404787,293349,698136,0,0,0
2004-09-03,0.79,331306,260532,591838,0,0,0
2004-09-07,0.7,418271,292067,710338,0,0,0
2004-09-08,0.81,437313,356345,793658,0,0,0
2004-09-09,0.72,483669,349029,832698,0,0,0
2004-09-10,0.61,573043,351284,924327,0,0,0
2004-09-13,0.56,684933,381638,1066571,0,0,0
2004-09-14,0.67,532990,355116,888106,0,0,0
2004-09-15,0.64,591782,377246,969028,0,0,0
2004-09-16,0.61,555654,340448,896102,0,0,0
2004-09-17,0.66,742190,487054,1229244,0,0,0
2004-09-20,0.58,652373,376265,1028638,0,0,0
2004-09-21,0.72,672724,483557,1156281,0,0,0
2004-09-22,0.95,500832,476806,977638,0,0,0
2004-09-23,0.81,438810,355896,794706,0,0,0
2004-09-24,0.82,380010,313474,693484,0,0,0
2004-09-27,0.79,429389,340689,770078,0,0,0
2004-09-28,0.85,520063,442490,962553,0,0,0
2004-09-29,0.65,644693,418040,1062733,0,0,0
2004-09-30,0.73,590577,433987,1024564,0,0,0
2004-10-01,0.77,705362,546099,1251461,0,0,0
2004-10-04,0.67,810433,539054,1349487,0,0,0
2004-10-05,0.67,740807,497794,1238601,0,0,0
2004-10-06,0.66,710852,468690,1179542,0,0,0
2004-10-07,0.75,624556,467848,1092404,0,0,0
2004-10-08,0.82,554096,456695,1010791,0,0,0
2004-10-11,0.62,437998,273185,711183,0,0,0
2004-10-12,0.9,569940,512918,1082858,0,0,0
2004-10-13,0.8,679170,542788,1221958,0,0,0
2004-10-14,0.85,667745,568304,1236049,0,0,0
2004-10-15,0.76,905837,691086,1596923,0,0,0
2004-10-18,0.71,653693,461948,1115641,0,0,0
2004-10-19,0.87,728489,633400,1361889,0,0,0
2004-10-20,0.83,636731,528293,1165024,0,0,0
2004-10-21,0.76,684642,519872,1204514,0,0,0
2004-10-22,0.67,549506,365979,915485,0,0,0
2004-10-25,0.66,526243,346298,872541,0,0,0
2004-10-26,0.58,705920,406927,1112847,0,0,0
2004-10-27,0.59,829704,486861,1316565,0,0,0
2004-10-28,0.55,654090,359641,1013731,0,0,0
2004-10-29,0.6,629879,378292,1008171,0,0,0
2004-11-01,0.76,489208,373860,863068,0,0,0
2004-11-02,0.55,723572,398622,1122194,0,0,0
2004-11-03,0.68,736263,499280,1235543,0,0,0
2004-11-04,0.64,735009,469860,1204869,0,0,0
2004-11-05,0.51,879460,444502,1323962,0,0,0
2004-11-08,0.49,707902,347942,1055844,0,0,0
2004-11-09,0.53,756787,401731,1158518,0,0,0
2004-11-10,0.57,722697,408807,1131504,0,0,0
2004-11-11,0.56,737734,414254,1151988,0,0,0
2004-11-12,0.64,869039,553135,1422174,0,0,0
2004-11-15,0.4,1023501,411086,1434587,0,0,0
2004-11-16,0.59,801638,474116,1275754,0,0,0
2004-11-17,0.51,1066235,544057,1610292,0,0,0
2004-11-18,0.5,911558,454881,1366439,0,0,0
2004-11-19,0.52,1161274,603669,1764943,0,0,0
2004-11-22,0.53,736999,393185,1130184,0,0,0
2004-11-23,0.66,731115,484224,1215339,0,0,0
2004-11-24,0.49,614365,299248,913613,0,0,0
2004-11-26,0.58,282314,163473,445787,0,0,0
2004-11-29,0.53,684379,363900,1048279,0,0,0
2004-11-30,0.69,480231,331968,812199,0,0,0
2004-12-01,0.53,801932,426488,1228420,0,0,0
2004-12-02,0.69,882049,611484,1493533,0,0,0
2004-12-03,0.54,726468,394888,1121356,0,0,0
2004-12-06,0.6,625907,374614,1000521,0,0,0
2004-12-07,0.59,758292,446314,1204606,0,0,0
2004-12-08,0.67,599048,398403,997451,0,0,0
2004-12-09,0.76,641624,489330,1130954,0,0,0
2004-12-10,0.47,611554,288555,900109,0,0,0
2004-12-13,0.47,552335,259531,811866,0,0,0
2004-12-14,0.61,702696,425477,1128173,0,0,0
2004-12-15,0.42,862039,360956,1222995,0,0,0
2004-12-16,0.44,934116,410355,1344471,0,0,0
2004-12-17,0.54,1002656,536541,1539197,0,0,0
2004-12-20,0.62,308472,189814,498286,0,0,0
2004-12-21,0.51,641805,329956,971761,0,0,0
2004-12-22,0.65,520858,337623,858481,0,0,0
2004-12-23,0.57,375124,212569,587693,0,0,0
2004-12-27,0.67,355513,237059,592572,0,0,0
2004-12-28,0.48,472655,227347,700002,0,0,0
2004-12-29,0.59,526021,310633,836654,0,0,0
2004-12-30,0.6,373995,223765,597760,0,0,0
2004-12-31,0.45,358909,162294,521203,0,0,0
2005-01-03,0.58,659825,379929,1039754,0,0,0
2005-01-04,0.6,823299,494997,1318296,0,0,0
2005-01-05,0.73,673198,491213,1164411,0,0,0
2005-01-06,0.67,650675,436787,1087462,0,0,0
2005-01-07,0.78,665551,517598,1183149,0,0,0
2005-01-10,0.65,598111,388796,986907,0,0,0
2005-01-11,0.65,710453,464212,1174665,0,0,0
2005-01-12,0.67,601109,401114,1002223,0,0,0
2005-01-13,0.68,711982,484745,1196727,0,0,0
2005-01-14,0.58,648600,378385,1026985,0,0,0
2005-01-18,0.67,748462,503077,1251539,0,0,0
2005-01-19,0.75,772118,578582,1350700,0,0,0
2005-01-20,0.76,850881,649157,1500038,0,0,0
2005-01-21,0.64,1173847,751545,1925392,0,0,0
2005-01-24,0.64,893746,570729,1464475,0,0,0
2005-01-25,0.63,734396,466131,1200527,0,0,0
2005-01-26,0.57,729240,417934,1147174,0,0,0
2005-01-27,0.53,624288,332165,956453,0,0,0
2005-01-28,0.61,640730,389257,1029987,0,0,0
2005-01-31,0.56,613507,341316,954823,0,0,0
2005-02-01,0.52,641260,331690,972950,0,0,0
2005-02-02,0.5,672941,335387,1008328,0,0,0
2005-02-03,0.64,589756,375712,965468,0,0,0
2005-02-04,0.49,749407,364407,1113814,0,0,0
2005-02-07,0.45,599882,271554,871436,0,0,0
2005-02-08,0.57,617796,353443,971239,0,0,0
2005-02-09,0.7,655340,459441,1114781,0,0,0
2005-02-10,0.75,596899,445552,1042451,0,0,0
2005-02-11,0.66,642824,424200,1067024,0,0,0
2005-02-14,0.67,538375,358232,896607,0,0,0
2005-02-15,0.54,697098,379812,1076910,0,0,0
2005-02-16,0.51,653283,336169,989452,0,0,0
2005-02-17,0.62,731649,451598,1183247,0,0,0
2005-02-18,0.59,953472,566068,1519540,0,0,0
2005-02-22,0.53,768716,404014,1172730,0,0,0
2005-02-23,0.56,615620,341717,957337,0,0,0
2005-02-24,0.78,702203,545456,1247659,0,0,0
2005-02-25,0.63,730242,461371,1191613,0,0,0
2005-02-28,0.55,691864,377079,1068943,0,0,0
2005-03-01,0.68,637463,430391,1067854,0,0,0
2005-03-02,0.62,677219,420572,1097791,0,0,0
2005-03-03,0.66,630262,417267,1047529,0,0,0
2005-03-04,0.61,679113,412901,1092014,0,0,0
2005-03-07,0.57,681352,385600,1066952,0,0,0
2005-03-08,0.68,596441,405869,1002310,0,0,0
2005-03-09,0.7,702190,492543,1194733,0,0,0
2005-03-10,0.66,641241,425365,1066606,0,0,0
2005-03-11,0.62,547342,340055,887397,0,0,0
2005-03-14,0.66,573341,381248,954589,0,0,0
2005-03-15,0.57,692111,392209,1084320,0,0,0
2005-03-16,0.83,736013,614202,1350215,0,0,0
2005-03-17,0.69,763771,525509,1289280,0,0,0
2005-03-18,0.72,860858,621100,1481958,0,0,0
2005-03-21,0.62,731526,455540,1187066,0,0,0
2005-03-22,0.82,675731,551035,1226766,0,0,0
2005-03-23,0.52,743807,384860,1128667,0,0,0
2005-03-24,0.5,707146,353431,1060577,0,0,0
2005-03-28,0.51,635349,323334,958683,0,0,0
2005-03-29,0.68,596786,408174,1004960,0,0,0
2005-03-30,0.57,588495,335703,924198,0,0,0
2005-03-31,0.58,617382,359396,976778,0,0,0
2005-04-01,0.81,596260,484520,1080780,0,0,0
2005-04-04,0.69,611025,422503,1033528,0,0,0
2005-04-05,0.6,599281,358050,957331,0,0,0
2005-04-06,0.81,612572,496312,1108884,0,0,0
2005-04-07,0.54,668755,361445,1030200,0,0,0
2005-04-08,0.55,565535,311177,876712,0,0,0
2005-04-11,0.71,552918,390898,943816,0,0,0
2005-04-12,0.68,684342,464286,1148628,0,0,0
2005-04-13,0.73,927550,674501,1602051,0,0,0
2005-04-14,0.7,949034,662345,1611379,0,0,0
2005-04-15,1.0,1090429,1095025,2185454,0,0,0
2005-04-18,0.69,848862,585156,1434018,0,0,0
2005-04-19,0.59,748795,441930,1190725,0,0,0
2005-04-20,0.63,743160,464946,1208106,0,0,0
2005-04-21,0.58,749890,436056,1185946,0,0,0
2005-04-22,0.67,621917,415520,1037437,0,0,0
2005-04-25,0.65,508636,328816,837452,0,0,0
2005-04-26,0.71,553686,391377,945063,0,0,0
2005-04-27,0.77,560549,430517,991066,0,0,0
2005-04-28,0.76,520202,396538,916740,0,0,0
2005-04-29,0.74,571583,421619,993202,0,0,0
2005-05-02,0.67,468299,315901,784200,0,0,0
2005-05-03,0.62,561365,345275,906640,0,0,0
2005-05-04,0.84,680649,573611,1254260,0,0,0
2005-05-05,0.74,552010,410429,962439,0,0,0
2005-05-06,0.8,459759,368858,828617,0,0,0
2005-05-09,0.63,472943,298648,771591,0,0,0
2005-05-10,0.53,629666,336792,966458,0,0,0
2005-05-11,0.7,537582,377032,914614,0,0,0
2005-05-12,0.74,564303,416152,980455,0,0,0
2005-05-13,0.72,629101,454105,1083206,0,0,0
2005-05-16,0.55,663109,362661,1025770,0,0,0
2005-05-17,0.69,611021,422280,1033301,0,0,0
2005-05-18,0.52,867498,451267,1318765,0,0,0
2005-05-19,0.53,724323,381008,1105331,0,0,0
2005-05-20,0.46,961822,441716,1403538,0,0,0
2005-05-23,0.51,729332,371719,1101051,0,0,0
2005-05-24,0.56,568897,318295,887192,0,0,0
2005-05-25,0.68,567764,387355,955119,0,0,0
2005-05-26,0.47,611297,287883,899180,0,0,0
2005-05-27,0.57,396841,227635,624476,0,0,0
2005-05-31,0.72,495953,354906,850859,0,0,0
2005-06-01,0.56,757708,426714,1184422,0,0,0
2005-06-02,0.62,530775,329231,860006,0,0,0
2005-06-03,0.61,535325,327222,862547,0,0,0
2005-06-06,0.51,486352,247606,733958,0,0,0
2005-06-07,0.56,630871,350996,981867,0,0,0
2005-06-08,0.64,578027,371287,949314,0,0,0
2005-06-09,0.48,597039,288848,885887,0,0,0
2005-06-10,0.47,681013,323436,1004449,0,0,0
2005-06-13,0.61,553331,336631,889962,0,0,0
2005-06-14,0.56,619778,345446,965224,0,0,0
2005-06-15,0.56,747538,420740,1168278,0,0,0
2005-06-16,0.73,787777,573484,1361261,0,0,0
2005-06-17,0.53,958796,511279,1470075,0,0,0
2005-06-20,0.58,655538,379451,1034989,0,0,0
2005-06-21,0.61,597482,363871,961353,0,0,0
2005-06-22,0.52,592603,309032,901635,0,0,0
2005-06-23,0.47,821689,387284,1208973,0,0,0
2005-06-24,0.57,512042,294419,806461,0,0,0
2005-06-27,0.63,524921,332144,857065,0,0,0
2005-06-28,0.58,529524,307966,837490,0,0,0
2005-06-29,0.61,548308,332022,880330,0,0,0
2005-06-30,0.51,593486,303667,897153,0,0,0
2005-07-01,0.55,395833,219261,615094,0,0,0
2005-07-05,0.49,557993,273561,831554,0,0,0
2005-07-06,0.52,546053,285517,831570,0,0,0
2005-07-07,0.58,593389,344815,938204,0,0,0
2005-07-08,0.42,722756,306563,1029319,0,0,0
2005-07-11,0.5,759728,377410,1137138,0,0,0
2005-07-12,0.46,771256,358279,1129535,0,0,0
2005-07-13,0.55,739592,408920,1148512,0,0,0
2005-07-14,0.43,1080451,469825,1550276,0,0,0
2005-07-15,0.54,986364,532999,1519363,0,0,0
2005-07-18,0.55,683489,378446,1061935,0,0,0
2005-07-19,0.54,742724,402559,1145283,0,0,0
2005-07-20,0.51,813078,414018,1227096,0,0,0
2005-07-21,0.54,832595,446913,1279508,0,0,0
2005-07-22,0.56,645307,362269,1007576,0,0,0
2005-07-25,0.6,633333,379218,1012551,0,0,0
2005-07-26,0.59,696465,410391,1106856,0,0,0
2005-07-27,0.59,678512,398339,1076851,0,0,0
2005-07-28,0.56,734103,411426,1145529,0,0,0
2005-07-29,0.66,622390,407743,1030133,0,0,0
2005-08-01,0.61,548154,332961,881115,0,0,0
2005-08-02,0.7,747595,521271,1268866,0,0,0
2005-08-03,0.56,709251,394813,1104064,0,0,0
2005-08-04,0.64,634138,405177,1039315,0,0,0
2005-08-05,0.55,636212,350676,986888,0,0,0
2005-08-08,0.6,646685,384837,1031522,0,0,0
2005-08-09,0.63,647931,410541,1058472,0,0,0
2005-08-10,0.6,734390,441440,1175830,0,0,0
2005-08-11,0.59,584797,345176,929973,0,0,0
2005-08-12,0.63,632943,395717,1028660,0,0,0
2005-08-15,0.57,670568,380863,1051431,0,0,0
2005-08-16,0.68,708570,485219,1193789,0,0,0
2005-08-17,0.54,784242,419900,1204142,0,0,0
2005-08-18,0.62,689591,428465,1118056,0,0,0
2005-08-19,0.58,781185,449642,1230827,0,0,0
2005-08-22,0.57,666747,382096,1048843,0,0,0
2005-08-23,0.61,578556,351100,929656,0,0,0
2005-08-24,0.71,586929,418565,1005494,0,0,0
2005-08-25,0.56,528412,298056,826468,0,0,0
2005-08-26,0.81,448785,365162,813947,0,0,0
2005-08-29,0.55,537298,296998,834296,0,0,0
2005-08-30,0.64,589726,374885,964611,0,0,0
2005-08-31,0.57,811626,459809,1271435,0,0,0
2005-09-01,0.58,745328,431760,1177088,0,0,0
2005-09-02,0.61,509861,312217,822078,0,0,0
2005-09-06,0.68,638870,432788,1071658,0,0,0
2005-09-07,0.55,627319,345314,972633,0,0,0
2005-09-08,0.62,714238,440160,1154398,0,0,0
2005-09-09,0.51,757568,386716,1144284,0,0,0
2005-09-12,0.59,743961,439732,1183693,0,0,0
2005-09-13,0.66,708456,470249,1178705,0,0,0
2005-09-14,0.67,803434,538952,1342386,0,0,0
2005-09-15,0.64,810714,517083,1327797,0,0,0
2005-09-16,0.52,1098208,573530,1671738,0,0,0
2005-09-19,0.5,858001,432738,1290739,0,0,0
2005-09-20,0.68,710333,481800,1192133,0,0,0
2005-09-21,0.71,832116,591923,1424039,0,0,0
2005-09-22,0.57,826934,469880,1296814,0,0,0
2005-09-23,0.63,647953,408078,1056031,0,0,0
2005-09-26,0.56,673247,380376,1053623,0,0,0
2005-09-27,0.6,603639,362267,965906,0,0,0
2005-09-28,0.55,713243,392052,1105295,0,0,0
2005-09-29,0.56,701237,392125,1093362,0,0,0
2005-09-30,0.53,687327,366854,1054181,0,0,0
2005-10-03,0.64,677321,434706,1112027,0,0,0
2005-10-04,0.62,796442,491296,1287738,0,0,0
2005-10-05,0.7,842911,585846,1428757,0,0,0
2005-10-06,0.61,869693,531452,1401145,0,0,0
2005-10-07,0.61,651506,396685,1048191,0,0,0
2005-10-10,0.8,608321,484431,1092752,0,0,0
2005-10-11,0.64,756399,482911,1239310,0,0,0
2005-10-12,0.76,886923,676571,1563494,0,0,0
2005-10-13,0.89,919301,819150,1738451,0,0,0
2005-10-14,0.7,636525,446915,1083440,0,0,0
2005-10-17,0.64,802967,515197,1318164,0,0,0
2005-10-18,0.67,767619,513873,1281492,0,0,0
2005-10-19,0.77,918615,705044,1623659,0,0,0
2005-10-20,0.75,984980,740998,1725978,0,0,0
2005-10-21,0.66,1120360,743390,1863750,0,0,0
2005-10-24,0.5,881291,442640,1323931,0,0,0
2005-10-25,0.59,801982,470425,1272407,0,0,0
2005-10-26,0.61,848287,518103,1366390,0,0,0
2005-10-27,0.66,794986,525897,1320883,0,0,0
2005-10-28,0.68,671365,453398,1124763,0,0,0
2005-10-31,0.52,760125,392108,1152233,0,0,0
2005-11-01,0.72,642605,461297,1103902,0,0,0
2005-11-02,0.49,992937,484898,1477835,0,0,0
2005-11-03,0.5,1023388,515558,1538946,0,0,0
2005-11-04,0.51,719235,366669,1085904,0,0,0
2005-11-07,0.69,652362,451590,1103952,0,0,0
2005-11-08,0.64,591658,376923,968581,0,0,0
2005-11-09,0.59,680742,399151,1079893,0,0,0
2005-11-10,0.62,834123,518509,1352632,0,0,0
2005-11-11,0.49,673176,327233,1000409,0,0,0
2005-11-14,0.59,730642,431004,1161646,0,0,0
2005-11-15,0.74,758301,564755,1323056,0,0,0
2005-11-16,0.58,821424,473081,1294505,0,0,0
2005-11-17,0.6,993075,600411,1593486,0,0,0
2005-11-18,0.46,1171163,536615,1707778,0,0,0
2005-11-21,0.58,819826,471894,1291720,0,0,0
2005-11-22,0.49,805404,395200,1200604,0,0,0
2005-11-23,0.55,772291,425952,1198243,0,0,0
2005-11-25,0.61,296467,180493,476960,0,0,0
2005-11-28,0.6,628246,375502,1003748,0,0,0
2005-11-29,0.62,667699,412915,1080614,0,0,0
2005-11-30,0.59,594610,350590,945200,0,0,0
2005-12-01,0.55,862936,472083,1335019,0,0,0
2005-12-02,0.58,769511,443058,1212569,0,0,0
2005-12-05,0.61,685572,417256,1102828,0,0,0
2005-12-06,0.64,800950,509606,1310556,0,0,0
2005-12-07,0.58,718334,416596,1134930,0,0,0
2005-12-08,0.64,722044,462701,1184745,0,0,0
2005-12-09,0.58,615871,357480,973351,0,0,0
2005-12-12,0.63,822289,521916,1344205,0,0,0
2005-12-13,0.52,1046986,548907,1595893,0,0,0
2005-12-14,0.57,971112,555550,1526662,0,0,0
2005-12-15,0.42,1157813,481038,1638851,0,0,0
2005-12-16,0.54,1153668,619101,1772769,0,0,0
2005-12-19,0.55,943659,519297,1462956,0,0,0
2005-12-20,0.77,603450,466073,1069523,0,0,0
2005-12-21,0.7,629721,441650,1071371,0,0,0
2005-12-22,0.56,635862,358639,994501,0,0,0
2005-12-23,0.51,457805,235090,692895,0,0,0
2005-12-27,0.76,603195,460064,1063259,0,0,0
2005-12-28,0.56,500968,278816,779784,0,0,0
2005-12-29,0.61,472984,288412,761396,0,0,0
2005-12-30,0.5,523253,263018,786271,0,0,0
2006-01-03,0.54,903009,489307,1392316,0,0,0
2006-01-04,0.49,848053,415967,1264020,0,0,0
2006-01-05,0.45,966279,435030,1401309,0,0,0
2006-01-06,0.58,1010308,588767,1599075,0,0,0
2006-01-09,0.47,1185024,551898,1736922,0,0,0
2006-01-10,0.55,1144851,630147,1774998,0,0,0
2006-01-11,0.53,1202151,632553,1834704,0,0,0
2006-01-12,0.55,1063956,579857,1643813,0,0,0
2006-01-13,0.59,909364,532461,1441825,0,0,0
2006-01-17,0.52,1065076,549965,1615041,0,0,0
2006-01-18,0.66,1017485,670116,1687601,0,0,0
2006-01-19,0.53,1424183,759403,2183586,0,0,0
2006-01-20,0.69,1756248,1214784,2971032,0,0,0
2006-01-23,0.58,1178701,688225,1866926,0,0,0
2006-01-24,0.37,1727564,647788,2375352,0,0,0
2006-01-25,0.62,1184212,729196,1913408,0,0,0
2006-01-26,0.55,1192483,655014,1847497,0,0,0
2006-01-27,0.59,1197856,709220,1907076,0,0,0
2006-01-30,0.47,1167555,543061,1710616,0,0,0
2006-01-31,0.51,956542,488462,1445004,0,0,0
2006-02-01,0.6,999262,599366,1598628,0,0,0
2006-02-02,0.68,990528,674859,1665387,0,0,0
2006-02-03,0.7,855502,596730,1452232,0,0,0
2006-02-06,0.7,803590,563099,1366689,0,0,0
2006-02-07,0.67,893530,595085,1488615,0,0,0
2006-02-08,0.6,910650,550209,1460859,0,0,0
2006-02-09,0.5,1032035,519302,1551337,0,0,0
2006-02-10,0.57,924159,530722,1454881,0,0,0
2006-02-13,0.67,787030,527996,1315026,0,0,0
2006-02-14,0.65,1033350,673208,1706558,0,0,0
2006-02-15,0.58,1104556,636759,1741315,0,0,0
2006-02-16,0.58,1148381,665033,1813414,0,0,0
2006-02-17,0.51,1242529,638193,1880722,0,0,0
2006-02-21,0.53,996852,533143,1529995,0,0,0
2006-02-22,0.51,943063,483849,1426912,0,0,0
2006-02-23,0.56,789251,438429,1227680,0,0,0
2006-02-24,0.64,758366,485230,1243596,0,0,0
2006-02-27,0.57,831872,477401,1309273,0,0,0
2006-02-28,0.57,965080,551544,1516624,0,0,0
2006-03-01,0.58,921386,538091,1459477,0,0,0
2006-03-02,0.64,981968,625927,1607895,0,0,0
2006-03-03,0.66,835893,554329,1390222,0,0,0
2006-03-06,0.67,916219,614299,1530518,0,0,0
2006-03-07,0.74,867278,641654,1508932,0,0,0
2006-03-08,0.63,1017656,640353,1658009,0,0,0
2006-03-09,0.74,868965,644907,1513872,0,0,0
2006-03-10,0.53,925234,490975,1416209,0,0,0
2006-03-13,0.66,762108,500887,1262995,0,0,0
2006-03-14,0.55,1028121,570100,1598221,0,0,0
2006-03-15,0.61,1140013,695682,1835695,0,0,0
2006-03-16,0.57,1076042,608157,1684199,0,0,0
2006-03-17,0.61,1165322,712418,1877740,0,0,0
2006-03-20,0.53,1096853,586479,1683332,0,0,0
2006-03-21,0.63,957135,603395,1560530,0,0,0
2006-03-22,0.63,832450,524869,1357319,0,0,0
2006-03-23,0.76,744746,562737,1307483,0,0,0
2006-03-24,0.63,789922,497255,1287177,0,0,0
2006-03-27,0.58,715592,417456,1133048,0,0,0
2006-03-28,0.64,837644,531952,1369596,0,0,0
2006-03-29,0.64,770439,493143,1263582,0,0,0
2006-03-30,0.47,901713,424961,1326674,0,0,0
2006-03-31,0.61,784143,474677,1258820,0,0,0
2006-04-03,0.45,883660,400849,1284509,0,0,0
2006-04-04,0.54,910926,491069,1401995,0,0,0
2006-04-05,0.64,942451,605757,1548208,0,0,0
2006-04-06,0.59,1079334,636594,1715928,0,0,0
2006-04-07,0.58,901866,519168,1421034,0,0,0
2006-04-10,0.65,782837,505843,1288680,0,0,0
2006-04-11,0.66,925684,610799,1536483,0,0,0
2006-04-12,0.58,800006,464364,1264370,0,0,0
2006-04-13,0.6,677896,408429,1086325,0,0,0
2006-04-17,0.56,1000696,558582,1559278,0,0,0
2006-04-18,0.51,1480617,755985,2236602,0,0,0
2006-04-19,0.46,1574316,722064,2296380,0,0,0
2006-04-20,0.54,1630439,884307,2514746,0,0,0
2006-04-21,0.6,1706400,1027005,2733405,0,0,0
2006-04-24,0.57,1124173,635777,1759950,0,0,0
2006-04-25,0.59,1087821,637862,1725683,0,0,0
2006-04-26,0.79,1078294,850427,1928721,0,0,0
2006-04-27,0.55,1283623,711373,1994996,0,0,0
2006-04-28,0.62,1037965,639744,1677709,0,0,0
2006-05-01,0.56,924809,519962,1444771,0,0,0
2006-05-02,0.62,986887,613928,1600815,0,0,0
2006-05-03,0.64,999862,635432,1635294,0,0,0
2006-05-04,0.51,1158502,591427,1749929,0,0,0
2006-05-05,0.48,1083842,520046,1603888,0,0,0
2006-05-08,0.63,962868,602256,1565124,0,0,0
2006-05-09,0.66,973164,642233,1615397,0,0,0
2006-05-10,0.62,1032724,637614,1670338,0,0,0
2006-05-11,0.64,1165656,747878,1913534,0,0,0
2006-05-12,0.72,1107430,798329,1905759,0,0,0
2006-05-15,0.65,1135331,735266,1870597,0,0,0
2006-05-16,0.63,1134248,712408,1846656,0,0,0
2006-05-17,0.8,1158768,922749,2081517,0,0,0
2006-05-18,0.75,1091898,817448,1909346,0,0,0
2006-05-19,0.75,1422747,1061118,2483865,0,0,0
2006-05-22,0.64,1252283,796381,2048664,0,0,0
2006-05-23,0.62,1040409,640651,1681060,0,0,0
2006-05-24,0.7,1093287,766482,1859769,0,0,0
2006-05-25,0.51,1114375,571749,1686124,0,0,0
2006-05-26,0.47,808353,378139,1186492,0,0,0
2006-05-30,0.67,759125,508441,1267566,0,0,0
2006-05-31,0.62,869293,538002,1407295,0,0,0
2006-06-01,0.76,798475,607811,1406286,0,0,0
2006-06-02,0.87,776644,675871,1452515,0,0,0
2006-06-05,0.64,825780,524851,1350631,0,0,0
2006-06-06,0.74,1015395,751336,1766731,0,0,0
2006-06-07,0.63,938168,589591,1527759,0,0,0
2006-06-08,0.79,1094396,864040,1958436,0,0,0
2006-06-09,0.63,795370,504705,1300075,0,0,0
2006-06-12,0.56,984341,554808,1539149,0,0,0
2006-06-13,0.78,1110659,860904,1971563,0,0,0
2006-06-14,0.76,852711,650223,1502934,0,0,0
2006-06-15,0.54,1172580,630729,1803309,0,0,0
2006-06-16,0.68,918677,624811,1543488,0,0,0
2006-06-19,0.59,886133,521838,1407971,0,0,0
2006-06-20,0.74,663639,493672,1157311,0,0,0
2006-06-21,0.55,805712,443453,1249165,0,0,0
2006-06-22,0.65,602843,389682,992525,0,0,0
2006-06-23,0.64,656897,420864,1077761,0,0,0
2006-06-26,0.57,577668,329137,906805,0,0,0
2006-06-27,0.66,813871,534260,1348131,0,0,0
2006-06-28,0.66,622034,412376,1034410,0,0,0
2006-06-29,0.46,1004469,460065,1464534,0,0,0
2006-06-30,0.52,713788,372160,1085948,0,0,0
2006-07-03,0.61,387172,234949,622121,0,0,0
2006-07-05,0.71,606685,429073,1035758,0,0,0
2006-07-06,0.63,739097,466975,1206072,0,0,0
2006-07-07,0.58,771564,445421,1216985,0,0,0
2006-07-10,0.6,769370,464132,1233502,0,0,0
2006-07-11,0.82,808082,658786,1466868,0,0,0
2006-07-12,0.84,686400,579730,1266130,0,0,0
2006-07-13,0.78,787023,612674,1399697,0,0,0
2006-07-14,0.78,863158,674483,1537641,0,0,0
2006-07-17,0.67,834175,555952,1390127,0,0,0
2006-07-18,0.78,943823,733243,1677066,0,0,0
2006-07-19,0.67,1156396,780161,1936557,0,0,0
2006-07-20,0.63,1209885,760294,1970179,0,0,0
2006-07-21,0.82,1276132,1045600,2321732,0,0,0
2006-07-24,0.53,1116566,586986,1703552,0,0,0
2006-07-25,0.57,1007108,575978,1583086,0,0,0
2006-07-26,0.61,1041604,634307,1675911,0,0,0
2006-07-27,0.62,997705,617452,1615157,0,0,0
2006-07-28,0.58,848286,491889,1340175,0,0,0
2006-07-31,0.64,746832,475644,1222476,0,0,0
2006-08-01,0.8,744649,592807,1337456,0,0,0
2006-08-02,0.52,962516,500136,1462652,0,0,0
2006-08-03,0.66,846732,559039,1405771,0,0,0
2006-08-04,0.7,738036,515338,1253374,0,0,0
2006-08-07,0.77,662245,511325,1173570,0,0,0
2006-08-08,0.91,742700,676878,1419578,0,0,0
2006-08-09,0.71,975962,692359,1668321,0,0,0
2006-08-10,0.75,762105,569069,1331174,0,0,0
2006-08-11,0.7,681566,475103,1156669,0,0,0
2006-08-14,0.67,811803,542293,1354096,0,0,0
2006-08-15,0.71,916554,648988,1565542,0,0,0
2006-08-16,0.52,1172617,609363,1781980,0,0,0
2006-08-17,0.6,1257102,752396,2009498,0,0,0
2006-08-18,0.57,1149606,649534,1799140,0,0,0
2006-08-21,0.76,711205,542493,1253698,0,0,0
2006-08-22,0.67,731698,489449,1221147,0,0,0
2006-08-23,0.79,637083,505897,1142980,0,0,0
2006-08-24,0.64,670484,431724,1102208,0,0,0
2006-08-25,0.58,606988,352539,959527,0,0,0
2006-08-28,0.65,616619,399970,1016589,0,0,0
2006-08-29,0.73,699648,510886,1210534,0,0,0
2006-08-30,0.65,738104,478803,1216907,0,0,0
2006-08-31,0.75,606733,453433,1060166,0,0,0
2006-09-01,0.67,619296,417615,1036911,0,0,0
2006-09-05,0.66,783341,514377,1297718,0,0,0
2006-09-06,0.79,757226,597584,1354810,0,0,0
2006-09-07,0.58,961162,562044,1523206,0,0,0
2006-09-08,0.73,704716,512641,1217357,0,0,0
2006-09-11,0.7,954060,666785,1620845,0,0,0
2006-09-12,0.7,1141581,801888,1943469,0,0,0
2006-09-13,0.53,1080409,572720,1653129,0,0,0
2006-09-14,0.79,930994,734469,1665463,0,0,0
2006-09-15,0.56,1292023,723043,2015066,0,0,0
2006-09-18,0.6,1037160,622167,1659327,0,0,0
2006-09-19,0.81,906597,736819,1643416,0,0,0
2006-09-20,0.58,1057282,614473,1671755,0,0,0
2006-09-21,0.74,876234,650638,1526872,0,0,0
2006-09-22,0.66,731865,480566,1212431,0,0,0
2006-09-25,0.65,1025509,668399,1693908,0,0,0
2006-09-26,0.73,940083,687702,1627785,0,0,0
2006-09-27,0.6,1044310,624410,1668720,0,0,0
2006-09-28,0.7,894494,629576,1524070,0,0,0
2006-09-29,0.62,718915,443354,1162269,0,0,0
2006-10-02,0.69,657698,452207,1109905,0,0,0
2006-10-03,0.98,874696,857728,1732424,0,0,0
2006-10-04,0.62,1097990,680860,1778850,0,0,0
2006-10-05,0.63,1067765,670220,1737985,0,0,0
2006-10-06,0.66,884097,581916,1466013,0,0,0
2006-10-09,0.67,823937,550171,1374108,0,0,0
2006-10-10,0.66,1049333,689372,1738705,0,0,0
2006-10-11,0.59,1013857,598370,1612227,0,0,0
2006-10-12,0.54,1077569,581408,1658977,0,0,0
2006-10-13,0.56,1083162,609063,1692225,0,0,0
2006-10-16,0.51,1168739,598963,1767702,0,0,0
2006-10-17,0.62,1140259,708300,1848559,0,0,0
2006-10-18,0.65,1160537,754132,1914669,0,0,0
2006-10-19,0.62,1359208,844458,2203666,0,0,0
2006-10-20,0.6,1617598,975804,2593402,0,0,0
2006-10-23,0.58,1202780,692722,1895502,0,0,0
2006-10-24,0.72,1113462,799047,1912509,0,0,0
2006-10-25,0.6,1322324,795144,2117468,0,0,0
2006-10-26,0.55,1192575,655157,1847732,0,0,0
2006-10-27,0.6,1013785,612875,1626660,0,0,0
2006-10-30,0.61,932086,564457,1496543,0,0,0
2006-10-31,0.63,992641,629254,1621895,0,0,0
2006-11-01,0.64,976510,623929,1600439,0,0,0
2006-11-02,0.61,1032775,628187,1660962,0,0,0
2006-11-03,0.64,959587,611603,1571190,0,0,0
2006-11-06,0.55,941869,521902,1463771,0,0,0
2006-11-07,0.57,1050981,597229,1648210,0,0,0
2006-11-08,0.68,1133823,767897,1901720,0,0,0
2006-11-09,0.61,1232216,750405,1982621,0,0,0
2006-11-10,0.79,639349,505880,1145229,0,0,0
2006-11-13,0.59,1038410,611855,1650265,0,0,0
2006-11-14,0.58,1148397,660989,1809386,0,0,0
2006-11-15,0.52,1291510,665999,1957509,0,0,0
2006-11-16,0.53,1433671,766665,2200336,0,0,0
2006-11-17,0.47,1681265,795461,2476726,0,0,0
2006-11-20,0.54,1149351,619934,1769285,0,0,0
2006-11-21,0.62,1160940,717196,1878136,0,0,0
2006-11-22,0.63,995476,630582,1626058,0,0,0
2006-11-24,0.52,419366,218771,638137,0,0,0
2006-11-27,0.68,1083666,739831,1823497,0,0,0
2006-11-28,0.65,958362,618374,1576736,0,0,0
2006-11-29,0.53,1118236,592235,1710471,0,0,0
2006-11-30,0.58,1108497,642390,1750887,0,0,0
2006-12-01,0.59,1003245,590574,1593819,0,0,0
2006-12-04,0.64,1056500,676096,1732596,0,0,0
2006-12-05,0.57,1073415,606768,1680183,0,0,0
2006-12-06,0.54,1119381,601676,1721057,0,0,0
2006-12-07,0.69,1104592,761228,1865820,0,0,0
2006-12-08,0.55,999365,551857,1551222,0,0,0
2006-12-11,0.57,1081065,612768,1693833,0,0,0
2006-12-12,0.7,1077606,753803,1831409,0,0,0
2006-12-13,0.57,1114386,632839,1747225,0,0,0
2006-12-14,0.45,1255504,564409,1819913,0,0,0
2006-12-15,0.5,1498167,747134,2245301,0,0,0
2006-12-18,0.59,1283115,753818,2036933,0,0,0
2006-12-19,0.67,988652,661923,1650575,0,0,0
2006-12-20,0.54,899598,489606,1389204,0,0,0
2006-12-21,0.45,1128889,503744,1632633,0,0,0
2006-12-22,0.66,570993,376790,947783,0,0,0
2006-12-26,0.62,603286,373894,977180,0,0,0
2006-12-27,0.68,621840,420898,1042738,0,0,0
2006-12-28,0.73,566152,412579,978731,0,0,0
2006-12-29,0.54,810965,434074,1245039,0,0,0
2007-01-03,0.59,1230104,731762,1961866,0,0,0
2007-01-04,0.51,1159836,592701,1752537,0,0,0
2007-01-05,0.59,1157209,687985,1845194,0,0,0
2007-01-08,0.71,972918,691748,1664666,0,0,0
2007-01-09,0.67,1197985,801313,1999298,0,0,0
2007-01-10,0.58,1300113,748542,2048655,0,0,0
2007-01-11,0.54,1356894,735073,2091967,0,0,0
2007-01-12,0.56,1106585,623461,1730046,0,0,0
2007-01-16,0.56,1279841,712538,1992379,0,0,0
2007-01-17,0.55,1233395,674863,1908258,0,0,0
2007-01-18,0.6,1325733,791613,2117346,0,0,0
2007-01-19,0.55,1593515,881479,2474994,0,0,0
2007-01-22,0.62,1088092,675333,1763425,0,0,0
2007-01-23,0.65,1223553,790123,2013676,0,0,0
2007-01-24,0.58,1172057,676577,1848634,0,0,0
2007-01-25,0.71,1073534,758640,1832174,0,0,0
2007-01-26,0.66,912556,599314,1511870,0,0,0
2007-01-29,0.6,940225,566863,1507088,0,0,0
2007-01-30,0.68,920694,622062,1542756,0,0,0
2007-01-31,0.56,1181595,666119,1847714,0,0,0
2007-02-01,0.57,1063501,611213,1674714,0,0,0
2007-02-02,0.7,844658,593475,1438133,0,0,0
2007-02-05,0.57,922313,526401,1448714,0,0,0
2007-02-06,0.55,1038197,568854,1607051,0,0,0
2007-02-07,0.65,943252,614583,1557835,0,0,0
2007-02-08,0.57,1100826,629489,1730315,0,0,0
2007-02-09,0.68,1159975,790774,1950749,0,0,0
2007-02-12,0.78,908986,705041,1614027,0,0,0
2007-02-13,0.74,1016051,753149,1769200,0,0,0
2007-02-14,0.67,1159297,781168,1940465,0,0,0
2007-02-15,0.54,1234529,662125,1896654,0,0,0
2007-02-16,0.55,1360369,750529,2110898,0,0,0
2007-02-20,0.65,1058078,689320,1747398,0,0,0
2007-02-21,0.71,994103,707541,1701644,0,0,0
2007-02-22,0.66,1085809,719998,1805807,0,0,0
2007-02-23,0.73,929758,681539,1611297,0,0,0
2007-02-26,0.75,1050507,785461,1835968,0,0,0
2007-02-27,0.87,1463993,1272649,2736642,0,0,0
2007-02-28,0.73,1228126,896791,2124917,0,0,0
2007-03-01,0.8,1217782,974156,2191938,0,0,0
2007-03-02,0.8,1025999,823520,1849519,0,0,0
2007-03-05,0.96,1046171,1005678,2051849,0,0,0
2007-03-06,0.77,1048674,807723,1856397,0,0,0
2007-03-07,0.7,945086,662472,1607558,0,0,0
2007-03-08,0.77,949126,734382,1683508,0,0,0
2007-03-09,0.82,827622,681651,1509273,0,0,0
2007-03-12,0.75,1053619,794156,1847775,0,0,0
2007-03-13,0.98,1195402,1173126,2368528,0,0,0
2007-03-14,0.89,1224646,1085713,2310359,0,0,0
2007-03-15,0.79,1092637,859862,1952499,0,0,0
2007-03-16,0.84,1184487,995100,2179587,0,0,0
2007-03-19,0.61,1235913,757390,1993303,0,0,0
2007-03-20,0.73,1127249,826445,1953694,0,0,0
2007-03-21,0.66,1204884,798927,2003811,0,0,0
2007-03-22,0.61,1025055,629065,1654120,0,0,0
2007-03-23,0.65,900803,581265,1482068,0,0,0
2007-03-26,0.69,827173,570320,1397493,0,0,0
2007-03-27,0.62,920016,568608,1488624,0,0,0
2007-03-28,0.89,966496,864935,1831431,0,0,0
2007-03-29,0.76,866994,661324,1528318,0,0,0
2007-03-30,0.67,940256,626489,1566745,0,0,0
2007-04-02,0.63,914105,576518,1490623,0,0,0
2007-04-03,0.66,1004292,666087,1670379,0,0,0
2007-04-04,0.74,883506,649560,1533066,0,0,0
2007-04-05,0.55,1162716,633799,1796515,0,0,0
2007-04-09,0.61,1035633,636388,1672021,0,0,0
2007-04-10,0.69,953731,660609,1614340,0,0,0
2007-04-11,0.69,1024356,706506,1730862,0,0,0
2007-04-12,0.73,1041100,755263,1796363,0,0,0
2007-04-13,0.67,1031074,687140,1718214,0,0,0
2007-04-16,0.56,1394652,783077,2177729,0,0,0
2007-04-17,0.67,1301619,878412,2180031,0,0,0
2007-04-18,0.54,1453399,787825,2241224,0,0,0
2007-04-19,0.62,1461941,905261,2367202,0,0,0
2007-04-20,0.5,1788062,895237,2683299,0,0,0
2007-04-23,0.58,1349659,779191,2128850,0,0,0
2007-04-24,0.73,1217618,884163,2101781,0,0,0
2007-04-25,0.6,1470190,887804,2357994,0,0,0
2007-04-26,0.6,1569953,945099,2515052,0,0,0
2007-04-27,0.58,1277940,735370,2013310,0,0,0
2007-04-30,0.64,1185377,760393,1945770,0,0,0
2007-05-01,0.73,1116403,816240,1932643,0,0,0
2007-05-02,0.56,1226082,686277,1912359,0,0,0
2007-05-03,0.66,1209303,792378,2001681,0,0,0
2007-05-04,0.54,1494194,812502,2306696,0,0,0
2007-05-07,0.45,1455319,660655,2115974,0,0,0
2007-05-08,0.6,1231348,742221,1973569,0,0,0
2007-05-09,0.53,1419004,756047,2175051,0,0,0
2007-05-10,0.68,1195255,816133,2011388,0,0,0
2007-05-11,0.62,1079230,673958,1753188,0,0,0
2007-05-14,0.51,1331131,672860,2003991,0,0,0
2007-05-15,0.63,1299945,823354,2123299,0,0,0
2007-05-16,0.7,1172298,823242,1995540,0,0,0
2007-05-17,0.49,1331813,652666,1984479,0,0,0
2007-05-18,0.51,1619359,829946,2449305,0,0,0
2007-05-21,0.55,1474992,817080,2292072,0,0,0
2007-05-22,0.6,1361135,821566,2182701,0,0,0
2007-05-23,0.67,1178752,789629,1968381,0,0,0
2007-05-24,0.67,1155240,769041,1924281,0,0,0
2007-05-25,0.55,857336,470678,1328014,0,0,0
2007-05-29,0.58,863991,496827,1360818,0,0,0
2007-05-30,0.65,1050146,685966,1736112,0,0,0
2007-05-31,0.51,1301206,664097,1965303,0,0,0
2007-06-01,0.5,1101483,554033,1655516,0,0,0
2007-06-04,0.52,1062898,557828,1620726,0,0,0
2007-06-05,0.63,1160539,732661,1893200,0,0,0
2007-06-06,0.62,1146512,710027,1856539,0,0,0
2007-06-07,0.72,1349399,972630,2322029,0,0,0
2007-06-08,0.6,1080223,649958,1730181,0,0,0
2007-06-11,0.71,1048514,746830,1795344,0,0,0
2007-06-12,0.66,1269153,831553,2100706,0,0,0
2007-06-13,0.58,1138485,659703,1798188,0,0,0
2007-06-14,0.53,1307836,696351,2004187,0,0,0
2007-06-15,0.48,1605445,763387,2368832,0,0,0
2007-06-18,0.58,1106690,641857,1748547,0,0,0
2007-06-19,0.62,1146946,715978,1862924,0,0,0
2007-06-20,0.63,1081439,679108,1760547,0,0,0
2007-06-21,0.61,1037282,635198,1672480,0,0,0
2007-06-22,0.62,931566,582187,1513753,0,0,0
2007-06-25,0.76,818848,618777,1437625,0,0,0
2007-06-26,0.71,939473,666175,1605648,0,0,0
2007-06-27,0.65,997223,646943,1644166,0,0,0
2007-06-28,0.59,991567,588401,1579968,0,0,0
2007-06-29,0.65,935333,608090,1543423,0,0,0
2007-07-02,0.54,937826,503488,1441314,0,0,0
2007-07-03,0.59,689780,404522,1094302,0,0,0
2007-07-05,0.55,1023507,567185,1590692,0,0,0
2007-07-06,0.53,932316,493053,1425369,0,0,0
2007-07-09,0.52,1111094,574650,1685744,0,0,0
2007-07-10,0.59,1215241,719509,1934750,0,0,0
2007-07-11,0.57,1209083,686541,1895624,0,0,0
2007-07-12,0.48,1657753,800516,2458269,0,0,0
2007-07-13,0.5,1442207,725263,2167470,0,0,0
2007-07-16,0.54,1386823,745058,2131881,0,0,0
2007-07-17,0.6,1451649,874240,2325889,0,0,0
2007-07-18,0.73,1483245,1081957,2565202,0,0,0
2007-07-19,0.54,1727252,929921,2657173,0,0,0
2007-07-20,0.69,1890521,1300745,3191266,0,0,0
2007-07-23,0.54,1476963,803337,2280300,0,0,0
2007-07-24,0.79,1466865,1153219,2620084,0,0,0
2007-07-25,0.64,1502520,965597,2468117,0,0,0
2007-07-26,0.85,1663605,1421333,3084938,0,0,0
2007-07-27,0.77,1371369,1060832,2432201,0,0,0
2007-07-30,0.71,1299230,922866,2222096,0,0,0
2007-07-31,0.72,1426469,1027279,2453748,0,0,0
2007-08-01,0.87,1387278,1212664,2599942,0,0,0
2007-08-02,0.77,1334467,1026747,2361214,0,0,0
2007-08-03,0.8,1338200,1064765,2402965,0,0,0
2007-08-06,0.84,1400865,1174113,2574978,0,0,0
2007-08-07,0.69,1394415,958341,2352756,0,0,0
2007-08-08,0.61,1744508,1065151,2809659,0,0,0
2007-08-09,0.65,1544053,1000455,2544508,0,0,0
2007-08-10,0.6,1719291,1036221,2755512,0,0,0
2007-08-13,0.71,1136918,803886,1940804,0,0,0
2007-08-14,1.06,992856,1047873,2040729,0,0,0
2007-08-15,1.05,1173424,1235861,2409285,0,0,0
2007-08-16,1.01,1752689,1773571,3526260,0,0,0
2007-08-17,0.74,1753295,1301896,3055191,0,0,0
2007-08-20,0.61,1180297,714534,1894831,0,0,0
2007-08-21,0.62,1055441,650116,1705557,0,0,0
2007-08-22,0.62,1221559,755042,1976601,0,0,0
2007-08-23,0.71,881783,623869,1505652,0,0,0
2007-08-24,0.68,800800,543989,1344789,0,0,0
2007-08-27,0.68,884415,604723,1489138,0,0,0
2007-08-28,0.87,949359,823054,1772413,0,0,0
2007-08-29,0.68,951733,650406,1602139,0,0,0
2007-08-30,0.65,873898,569130,1443028,0,0,0
2007-08-31,0.65,779261,504601,1283862,0,0,0
2007-09-04,0.67,1096387,738830,1835217,0,0,0
2007-09-05,0.72,1160782,832397,1993179,0,0,0
2007-09-06,0.62,876945,546842,1423787,0,0,0
2007-09-07,0.77,919498,703590,1623088,0,0,0
2007-09-10,0.78,851890,667665,1519555,0,0,0
2007-09-11,0.84,895250,748339,1643589,0,0,0
2007-09-12,0.58,1020899,593356,1614255,0,0,0
2007-09-13,0.61,966560,592279,1558839,0,0,0
2007-09-14,0.63,908511,574968,1483479,0,0,0
2007-09-17,0.65,881059,573476,1454535,0,0,0
2007-09-18,0.69,1348807,934676,2283483,0,0,0
2007-09-19,0.58,1642571,951737,2594308,0,0,0
2007-09-20,0.56,1252165,705351,1957516,0,0,0
2007-09-21,0.53,1521591,805154,2326745,0,0,0
2007-09-24,0.61,1222414,743443,1965857,0,0,0
2007-09-25,0.75,1111547,832450,1943997,0,0,0
2007-09-26,0.6,1198924,717134,1916058,0,0,0
2007-09-27,0.58,1113878,647098,1760976,0,0,0
2007-09-28,0.78,889356,692975,1582331,0,0,0
2007-10-01,0.57,1119022,633781,1752803,0,0,0
2007-10-02,0.66,1225890,810191,2036081,0,0,0
2007-10-03,0.58,1092924,637006,1729930,0,0,0
2007-10-04,0.5,1259940,624588,1884528,0,0,0
2007-10-05,0.56,1130305,637207,1767512,0,0,0
2007-10-08,0.52,950464,498584,1449048,0,0,0
2007-10-09,0.61,1332121,816955,2149076,0,0,0
2007-10-10,0.56,1309421,730723,2040144,0,0,0
2007-10-11,0.6,1804867,1084417,2889284,0,0,0
2007-10-12,0.56,1609905,908216,2518121,0,0,0
2007-10-15,0.53,1475006,778702,2253708,0,0,0
2007-10-16,0.75,1426924,1068330,2495254,0,0,0
2007-10-17,0.67,1689623,1126876,2816499,0,0,0
2007-10-18,0.52,1775711,930835,2706546,0,0,0
2007-10-19,0.73,1859772,1360719,3220491,0,0,0
2007-10-22,0.66,1404675,933073,2337748,0,0,0
2007-10-23,0.64,1431696,918852,2350548,0,0,0
2007-10-24,0.73,1348644,979204,2327848,0,0,0
2007-10-25,0.76,1190094,909902,2099996,0,0,0
2007-10-26,0.53,1561917,828776,2390693,0,0,0
2007-10-29,0.57,1329763,758841,2088604,0,0,0
2007-10-30,0.84,1120683,942717,2063400,0,0,0
2007-10-31,0.45,1663140,746529,2409669,0,0,0
2007-11-01,0.68,1458838,986693,2445531,0,0,0
2007-11-02,0.7,1355405,947257,2302662,0,0,0
2007-11-05,0.67,1317923,888547,2206470,0,0,0
2007-11-06,0.71,1532786,1089080,2621866,0,0,0
2007-11-07,0.67,1532867,1033652,2566519,0,0,0
2007-11-08,0.83,1819598,1505744,3325342,0,0,0
2007-11-09,0.72,1381627,992718,2374345,0,0,0
2007-11-12,0.59,1927681,1141568,3069249,0,0,0
2007-11-13,0.85,1544277,1311050,2855327,0,0,0
2007-11-14,0.62,1439510,898741,2338251,0,0,0
2007-11-15,0.8,1186207,944825,2131032,0,0,0
2007-11-16,0.99,1369644,1358457,2728101,0,0,0
2007-11-19,0.66,1203511,791460,1994971,0,0,0
2007-11-20,0.79,1407304,1107824,2515128,0,0,0
2007-11-21,0.82,1068872,876930,1945802,0,0,0
2007-11-23,0.54,530007,287627,817634,0,0,0
2007-11-26,0.7,1117055,777972,1895027,0,0,0
2007-11-27,0.55,1911996,1045342,2957338,0,0,0
2007-11-28,0.57,1501673,848505,2350178,0,0,0
2007-11-29,0.59,1147632,678326,1825958,0,0,0
2007-11-30,0.68,1146285,778126,1924411,0,0,0
2007-12-03,0.62,897288,554351,1451639,0,0,0
2007-12-04,0.87,1016081,887693,1903774,0,0,0
2007-12-05,0.63,1071003,675771,1746774,0,0,0
2007-12-06,0.55,1235003,675128,1910131,0,0,0
2007-12-07,0.6,998449,599927,1598376,0,0,0
2007-12-10,0.68,1055938,722249,1778187,0,0,0
2007-12-11,0.79,1253059,992824,2245883,0,0,0
2007-12-12,0.68,1293283,874925,2168208,0,0,0
2007-12-13,0.74,1100101,811075,1911176,0,0,0
2007-12-14,0.62,1042011,643156,1685167,0,0,0
2007-12-17,0.64,1133282,721404,1854686,0,0,0
2007-12-18,0.77,1289770,993053,2282823,0,0,0
2007-12-19,0.71,1154627,816768,1971395,0,0,0
2007-12-20,0.42,2266397,948198,3214595,0,0,0
2007-12-21,0.64,1548653,998615,2547268,0,0,0
2007-12-24,0.72,639971,458002,1097973,0,0,0
2007-12-26,0.66,862958,567624,1430582,0,0,0
2007-12-27,0.6,923330,556422,1479752,0,0,0
2007-12-28,0.56,936505,528559,1465064,0,0,0
2007-12-31,0.67,861127,581057,1442184,0,0,0
2008-01-02,0.78,1047459,818971,1866430,0,0,0
2008-01-03,0.71,1164859,830272,1995131,0,0,0
2008-01-04,0.61,1833058,1123843,2956901,0,0,0
2008-01-07,0.78,1283956,996429,2280385,0,0,0
2008-01-08,0.97,1391811,1354459,2746270,0,0,0
2008-01-09,0.75,1686205,1261271,2947476,0,0,0
2008-01-10,0.69,1624753,1124761,2749514,0,0,0
2008-01-11,0.71,1501985,1068863,2570848,0,0,0
2008-01-14,0.7,1300604,905704,2206308,0,0,0
2008-01-15,1.05,1514259,1588729,3102988,0,0,0
2008-01-16,0.87,1670219,1450336,3120555,0,0,0
2008-01-17,0.99,1563319,1545183,3108502,0,0,0
2008-01-18,0.99,1689111,1671608,3360719,0,0,0
2008-01-22,0.73,1650001,1210035,2860036,0,0,0
2008-01-23,0.75,2022956,1515883,3538839,0,0,0
2008-01-24,0.59,1756715,1030690,2787405,0,0,0
2008-01-25,0.67,1334453,894457,2228910,0,0,0
2008-01-28,0.64,1090714,703431,1794145,0,0,0
2008-01-29,0.65,1304678,853281,2157959,0,0,0
2008-01-30,0.62,1388854,866641,2255495,0,0,0
2008-01-31,0.7,1420126,994553,2414679,0,0,0
2008-02-01,0.56,1655910,926413,2582323,0,0,0
2008-02-04,0.68,1100721,752086,1852807,0,0,0
2008-02-05,0.94,1169153,1102497,2271650,0,0,0
2008-02-06,0.8,1106316,885085,1991401,0,0,0
2008-02-07,0.88,1251116,1101549,2352665,0,0,0
2008-02-08,0.79,1025314,811140,1836454,0,0,0
2008-02-11,0.68,1164587,789834,1954421,0,0,0
2008-02-12,0.78,1368634,1073893,2442527,0,0,0
2008-02-13,0.75,1083169,815995,1899164,0,0,0
2008-02-14,0.74,1128694,834505,1963199,0,0,0
2008-02-15,0.78,1254792,975000,2229792,0,0,0
2008-02-19,0.67,1262963,843204,2106167,0,0,0
2008-02-20,0.7,1105864,774172,1880036,0,0,0
2008-02-21,0.69,1024261,709348,1733609,0,0,0
2008-02-22,0.84,921121,771956,1693077,0,0,0
2008-02-25,0.65,1047599,682566,1730165,0,0,0
2008-02-26,0.8,1173488,940009,2113497,0,0,0
2008-02-27,0.74,1050971,775979,1826950,0,0,0
2008-02-28,0.96,997910,958602,1956512,0,0,0
2008-02-29,0.84,1031151,870766,1901917,0,0,0
2008-03-03,0.79,1066089,845347,1911436,0,0,0
2008-03-04,0.96,1189930,1141182,2331112,0,0,0
2008-03-05,0.68,1037764,703561,1741325,0,0,0
2008-03-06,1.12,990828,1109591,2100419,0,0,0
2008-03-07,0.92,1145830,1056101,2201931,0,0,0
2008-03-10,1.0,1055402,1051758,2107160,0,0,0
2008-03-11,0.89,1325081,1174964,2500045,0,0,0
2008-03-12,0.84,1168372,976710,2145082,0,0,0
2008-03-13,0.82,1270533,1047530,2318063,0,0,0
2008-03-14,1.16,1178150,1365552,2543702,0,0,0
2008-03-17,1.34,1351521,1814313,3165834,0,0,0
2008-03-18,0.78,1678548,1317287,2995835,0,0,0
2008-03-19,0.9,1551367,1392187,2943554,0,0,0
2008-03-20,0.81,1815036,1467874,3282910,0,0,0
2008-03-24,0.63,1575484,991208,2566692,0,0,0
2008-03-25,0.77,1219736,938317,2158053,0,0,0
2008-03-26,0.77,1207437,930997,2138434,0,0,0
2008-03-27,0.85,1064793,901768,1966561,0,0,0
2008-03-28,0.86,889802,763764,1653566,0,0,0
2008-03-31,0.85,880437,748399,1628836,0,0,0
2008-04-01,0.81,1292552,1041654,2334206,0,0,0
2008-04-02,0.78,1181232,923507,2104739,0,0,0
2008-04-03,0.82,1063288,867830,1931118,0,0,0
2008-04-04,0.82,1090589,888857,1979446,0,0,0
2008-04-07,0.74,1261082,937309,2198391,0,0,0
2008-04-08,0.9,937309,840947,1778256,0,0,0
2008-04-09,0.9,957134,859679,1816813,0,0,0
2008-04-10,0.79,1115495,882401,1997896,0,0,0
2008-04-11,0.9,1156445,1035391,2191836,0,0,0
2008-04-14,0.85,1062214,904620,1966834,0,0,0
2008-04-15,0.94,1103053,1040621,2143674,0,0,0
2008-04-16,0.72,1523812,1102020,2625832,0,0,0
2008-04-17,0.75,1364348,1024573,2388921,0,0,0
2008-04-18,0.59,2074614,1223920,3298534,0,0,0
2008-04-21,0.6,1437746,859213,2296959,0,0,0
2008-04-22,0.66,1431134,949162,2380296,0,0,0
2008-04-23,0.7,1297079,907144,2204223,0,0,0
2008-04-24,0.67,1485218,987812,2473030,0,0,0
2008-04-25,0.73,1286873,935163,2222036,0,0,0
2008-04-28,0.66,1081649,715552,1797201,0,0,0
2008-04-29,0.83,1184337,978921,2163258,0,0,0
2008-04-30,0.66,1279350,838444,2117794,0,0,0
2008-05-01,0.58,1625225,936186,2561411,0,0,0
2008-05-02,0.62,1463659,914771,2378430,0,0,0
2008-05-05,0.66,1459412,967118,2426530,0,0,0
2008-05-06,0.57,1694944,971356,2666300,0,0,0
2008-05-07,0.66,1532500,1016116,2548616,0,0,0
2008-05-08,0.6,1379222,827643,2206865,0,0,0
2008-05-09,0.7,1166467,815717,1982184,0,0,0
2008-05-12,0.66,1475590,970195,2445785,0,0,0
2008-05-13,0.6,1574325,945252,2519577,0,0,0
2008-05-14,0.62,1639066,1018269,2657335,0,0,0
2008-05-15,0.59,1665011,986604,2651615,0,0,0
2008-05-16,0.59,1832609,1075511,2908120,0,0,0
2008-05-19,0.56,1646289,918074,2564363,0,0,0
2008-05-20,0.7,1264438,884310,2148748,0,0,0
2008-05-21,0.79,1400279,1107649,2507928,0,0,0
2008-05-22,0.63,1176044,735328,1911372,0,0,0
2008-05-23,0.72,1161498,830802,1992300,0,0,0
2008-05-27,0.66,1029808,675743,1705551,0,0,0
2008-05-28,0.62,1207365,748538,1955903,0,0,0
2008-05-29,0.67,1296524,864347,2160871,0,0,0
2008-05-30,0.59,1096856,649606,1746462,0,0,0
2008-06-02,0.76,1092911,825569,1918480,0,0,0
2008-06-03,0.8,1308822,1040584,2349406,0,0,0
2008-06-04,0.76,1241962,943398,2185360,0,0,0
2008-06-05,0.64,1470027,941644,2411671,0,0,0
2008-06-06,0.76,1528100,1161267,2689367,0,0,0
2008-06-09,0.78,1588449,1243178,2831627,0,0,0
2008-06-10,0.81,1317130,1071254,2388384,0,0,0
2008-06-11,0.85,1426996,1208661,2635657,0,0,0
2008-06-12,0.77,1683010,1302295,2985305,0,0,0
2008-06-13,0.76,1578395,1195919,2774314,0,0,0
2008-06-16,0.81,1397311,1130013,2527324,0,0,0
2008-06-17,0.75,1417831,1065394,2483225,0,0,0
2008-06-18,0.86,1484228,1279325,2763553,0,0,0
2008-06-19,0.76,1818519,1384975,3203494,0,0,0
2008-06-20,0.92,1725837,1582696,3308533,0,0,0
2008-06-23,0.65,1602539,1045996,2648535,0,0,0
2008-06-24,0.7,1268171,892176,2160347,0,0,0
2008-06-25,0.71,1502525,1066269,2568794,0,0,0
2008-06-26,0.79,1579838,1244666,2824504,0,0,0
2008-06-27,0.81,1364226,1108971,2473197,0,0,0
2008-06-30,0.77,1256051,966644,2222695,0,0,0
2008-07-01,0.8,1530534,1231636,2762170,0,0,0
2008-07-02,0.71,1686747,1194110,2880857,0,0,0
2008-07-03,0.85,1032849,879981,1912830,0,0,0
2008-07-07,0.9,1521946,1365111,2887057,0,0,0
2008-07-08,0.74,1906513,1402387,3308900,0,0,0
2008-07-09,0.84,1479884,1237598,2717482,0,0,0
2008-07-10,0.93,1601147,1490108,3091255,0,0,0
2008-07-11,0.91,1850800,1681920,3532720,0,0,0
2008-07-14,0.93,1514073,1405153,2919226,0,0,0
2008-07-15,0.94,1905654,1797457,3703111,0,0,0
2008-07-16,0.78,2073655,1609915,3683570,0,0,0
2008-07-17,0.74,2449612,1823778,4273390,0,0,0
2008-07-18,0.72,2053123,1470599,3523722,0,0,0
2008-07-21,0.7,1768964,1235915,3004879,0,0,0
2008-07-22,0.77,1865392,1437208,3302600,0,0,0
2008-07-23,0.65,2142589,1389064,3531653,0,0,0
2008-07-24,0.82,1682968,1373749,3056717,0,0,0
2008-07-25,0.73,1278952,939700,2218652,0,0,0
2008-07-28,0.8,1188889,947144,2136033,0,0,0
2008-07-29,0.68,1651151,1122179,2773330,0,0,0
2008-07-30,0.72,1805087,1293000,3098087,0,0,0
2008-07-31,0.73,1653225,1207365,2860590,0,0,0
2008-08-01,0.86,1969569,1684730,3654299,0,0,0
2008-08-04,0.72,1214331,871108,2085439,0,0,0
2008-08-05,0.63,1833655,1146763,2980418,0,0,0
2008-08-06,0.73,1395087,1021884,2416971,0,0,0
2008-08-07,0.83,1317219,1096082,2413301,0,0,0
2008-08-08,0.59,1537813,910645,2448458,0,0,0
2008-08-11,0.68,1668432,1135115,2803547,0,0,0
2008-08-12,0.73,1505822,1099650,2605472,0,0,0
2008-08-13,0.72,1479094,1058376,2537470,0,0,0
2008-08-14,0.7,1369339,953508,2322847,0,0,0
2008-08-15,0.65,1561722,1017353,2579075,0,0,0
2008-08-18,0.76,1184562,899213,2083775,0,0,0
2008-08-19,0.88,1008757,882711,1891468,0,0,0
2008-08-20,0.7,1142776,794411,1937187,0,0,0
2008-08-21,0.65,988313,647284,1635597,0,0,0
2008-08-22,0.59,954718,567786,1522504,0,0,0
2008-08-25,0.71,721153,510353,1231506,0,0,0
2008-08-26,0.8,832937,669626,1502563,0,0,0
2008-08-27,0.69,909472,628672,1538144,0,0,0
2008-08-28,0.72,1069675,771941,1841616,0,0,0
2008-08-29,0.71,764000,543560,1307560,0,0,0
2008-09-02,0.69,1237480,855129,2092609,0,0,0
2008-09-03,0.68,1373289,933331,2306620,0,0,0
2008-09-04,0.79,1440928,1135145,2576073,0,0,0
2008-09-05,0.78,1410026,1103579,2513605,0,0,0
2008-09-08,0.77,1764118,1359159,3123277,0,0,0
2008-09-09,1.0,1640945,1636900,3277845,0,0,0
2008-09-10,0.85,1488897,1269227,2758124,0,0,0
2008-09-11,0.83,1787802,1487736,3275538,0,0,0
2008-09-12,0.9,1727538,1547842,3275380,0,0,0
2008-09-15,1.18,1342619,1584395,2927014,0,0,0
2008-09-16,0.94,1783956,1671688,3455644,0,0,0
2008-09-17,0.98,1852950,1824140,3677090,0,0,0
2008-09-18,0.81,2259042,1821459,4080501,0,0,0
2008-09-19,0.51,2421983,1241857,3663840,0,0,0
2008-09-22,0.73,1382320,1005732,2388052,0,0,0
2008-09-23,0.76,1193075,912294,2105369,0,0,0
2008-09-24,0.71,1010855,721281,1732136,0,0,0
2008-09-25,0.63,1320908,828195,2149103,0,0,0
2008-09-26,0.82,1185821,971227,2157048,0,0,0
2008-09-29,0.79,1293507,1022631,2316138,0,0,0
2008-09-30,0.73,1252444,908952,2161396,0,0,0
2008-10-01,0.79,1338897,1059921,2398818,0,0,0
2008-10-02,0.92,1399107,1283002,2682109,0,0,0
2008-10-03,0.73,1574755,1156113,2730868,0,0,0
2008-10-06,0.96,1902376,1835224,3737600,0,0,0
2008-10-07,0.95,1460722,1388645,2849367,0,0,0
2008-10-08,0.9,1769555,1584168,3353723,0,0,0
2008-10-09,1.06,1478394,1567000,3045394,0,0,0
2008-10-10,1.02,1913759,1952805,3866564,0,0,0
2008-10-13,0.69,1596842,1109383,2706225,0,0,0
2008-10-14,0.81,1578044,1275653,2853697,0,0,0
2008-10-15,0.91,1386063,1256060,2642123,0,0,0
2008-10-16,0.94,1477834,1387342,2865176,0,0,0
2008-10-17,0.82,1535165,1260237,2795402,0,0,0
2008-10-20,0.63,1265425,795504,2060929,0,0,0
2008-10-21,0.77,1109227,855276,1964503,0,0,0
2008-10-22,0.9,1179583,1059873,2239456,0,0,0
2008-10-23,0.92,1231525,1132454,2363979,0,0,0
2008-10-24,0.98,1120310,1098829,2219139,0,0,0
2008-10-27,0.82,873685,715387,1589072,0,0,0
2008-10-28,0.68,1408736,952870,2361606,0,0,0
2008-10-29,0.59,1477290,866574,2343864,0,0,0
2008-10-30,0.69,1333112,914332,2247444,0,0,0
2008-10-31,0.75,1273050,953718,2226768,0,0,0
2008-11-03,0.75,1075939,812211,1888150,0,0,0
2008-11-04,0.71,1443728,1019296,2463024,0,0,0
2008-11-05,0.81,1379412,1114328,2493740,0,0,0
2008-11-06,1.02,1193339,1216186,2409525,0,0,0
2008-11-07,0.76,927288,701379,1628667,0,0,0
2008-11-10,0.93,884205,826201,1710406,0,0,0
2008-11-11,0.96,1038145,994468,2032613,0,0,0
2008-11-12,0.98,1104410,1085539,2189949,0,0,0
2008-11-13,0.93,1726252,1601226,3327478,0,0,0
2008-11-14,0.83,1095108,904487,1999595,0,0,0
2008-11-17,0.86,984340,850733,1835073,0,0,0
2008-11-18,0.94,1151512,1087598,2239110,0,0,0
2008-11-19,1.16,1211029,1408842,2619871,0,0,0
2008-11-20,1.05,1446741,1517393,2964134,0,0,0
2008-11-21,1.13,1619871,1826536,3446407,0,0,0
2008-11-24,0.57,1592804,900475,2493279,0,0,0
2008-11-25,0.7,1158691,805525,1964216,0,0,0
2008-11-26,0.64,1149658,739983,1889641,0,0,0
2008-11-28,0.72,512694,368653,881347,0,0,0
2008-12-01,0.89,949646,846185,1795831,0,0,0
2008-12-02,0.75,1080821,809333,1890154,0,0,0
2008-12-03,0.74,1070178,791719,1861897,0,0,0
2008-12-04,0.81,1008848,814555,1823403,0,0,0
2008-12-05,0.62,1291605,804061,2095666,0,0,0
2008-12-08,0.73,1577244,1154106,2731350,0,0,0
2008-12-09,0.74,1189758,884384,2074142,0,0,0
2008-12-10,0.77,1083758,832206,1915964,0,0,0
2008-12-11,0.84,1074766,902809,1977575,0,0,0
2008-12-12,0.92,925457,853638,1779095,0,0,0
2008-12-15,0.88,736447,650082,1386529,0,0,0
2008-12-16,0.72,1308821,946344,2255165,0,0,0
2008-12-17,0.64,1343204,858151,2201355,0,0,0
2008-12-18,0.81,1230926,999652,2230578,0,0,0
2008-12-19,0.69,1220776,838342,2059118,0,0,0
2008-12-22,0.68,853601,580821,1434422,0,0,0
2008-12-23,0.48,836232,402758,1238990,0,0,0
2008-12-24,0.65,295739,193142,488881,0,0,0
2008-12-26,0.65,429376,278407,707783,0,0,0
2008-12-29,0.62,727955,449706,1177661,0,0,0
2008-12-30,0.62,798956,497416,1296372,0,0,0
2008-12-31,0.61,791300,481515,1272815,0,0,0
2009-01-02,0.66,964210,638643,1602853,0,0,0
2009-01-05,0.67,1307047,878373,2185420,0,0,0
2009-01-06,0.73,1474737,1075719,2550456,0,0,0
2009-01-07,1.0,1132997,1135307,2268304,0,0,0
2009-01-08,0.89,1099483,979449,2078932,0,0,0
2009-01-09,0.87,1096044,950303,2046347,0,0,0
2009-01-12,0.99,1125670,1119174,2244844,0,0,0
2009-01-13,0.92,1163243,1075534,2238777,0,0,0
2009-01-14,0.98,1282889,1256710,2539599,0,0,0
2009-01-15,1.0,1723452,1730207,3453659,0,0,0
2009-01-16,0.82,1682537,1377134,3059671,0,0,0
2009-01-20,0.9,1509550,1353709,2863259,0,0,0
2009-01-21,0.8,1399180,1115623,2514803,0,0,0
2009-01-22,0.76,1477597,1116828,2594425,0,0,0
2009-01-23,0.68,1453233,989170,2442403,0,0,0
2009-01-26,0.66,1240524,818344,2058868,0,0,0
2009-01-27,0.68,1121552,759502,1881054,0,0,0
2009-01-28,0.62,1447189,895809,2342998,0,0,0
2009-01-29,0.89,1023529,910111,1933640,0,0,0
2009-01-30,0.87,1052450,916067,1968517,0,0,0
2009-02-02,0.75,1114338,841196,1955534,0,0,0
2009-02-03,0.77,1119821,860276,1980097,0,0,0
2009-02-04,0.78,1234221,966799,2201020,0,0,0
2009-02-05,0.73,1532511,1120016,2652527,0,0,0
2009-02-06,0.59,1625078,952887,2577965,0,0,0
2009-02-09,0.63,1323210,839517,2162727,0,0,0
2009-02-10,0.76,1415864,1076257,2492121,0,0,0
2009-02-11,0.81,1107140,892960,2000100,0,0,0
2009-02-12,0.89,1172941,1039968,2212909,0,0,0
2009-02-13,0.74,947296,700021,1647317,0,0,0
2009-02-17,0.95,1194461,1133739,2328200,0,0,0
2009-02-18,0.89,1196297,1060224,2256521,0,0,0
2009-02-19,0.95,1247849,1190871,2438720,0,0,0
2009-02-20,0.83,1924048,1594599,3518647,0,0,0
2009-02-23,0.8,1336108,1063709,2399817,0,0,0
2009-02-24,0.64,1476645,941104,2417749,0,0,0
2009-02-25,0.65,1243804,803362,2047166,0,0,0
2009-02-26,0.66,1282372,840644,2123016,0,0,0
2009-02-27,0.69,1328906,917345,2246251,0,0,0
2009-03-02,0.86,1321989,1136676,2458665,0,0,0
2009-03-03,0.79,1191603,941209,2132812,0,0,0
2009-03-04,0.84,1448246,1211685,2659931,0,0,0
2009-03-05,0.9,1352091,1216788,2568879,0,0,0
2009-03-06,0.83,1416349,1175214,2591563,0,0,0
2009-03-09,0.61,1273119,778499,2051618,0,0,0
2009-03-10,0.57,1720985,984989,2705974,0,0,0
2009-03-11,0.66,1518907,998908,2517815,0,0,0
2009-03-12,0.61,1712447,1052783,2765230,0,0,0
2009-03-13,0.61,1542737,935321,2478058,0,0,0
2009-03-16,0.69,1834848,1273360,3108208,0,0,0
2009-03-17,0.66,1586340,1053744,2640084,0,0,0
2009-03-18,0.54,2578948,1404566,3983514,0,0,0
2009-03-19,0.57,2299602,1302202,3601804,0,0,0
2009-03-20,0.73,1868126,1357148,3225274,0,0,0
2009-03-23,0.52,2179719,1122830,3302549,0,0,0
2009-03-24,0.62,1544063,958177,2502240,0,0,0
2009-03-25,0.64,1493215,954897,2448112,0,0,0
2009-03-26,0.67,1434339,956087,2390426,0,0,0
2009-03-27,0.74,1058639,785890,1844529,0,0,0
2009-03-30,0.77,1206714,932949,2139663,0,0,0
2009-03-31,0.66,1219278,801718,2020996,0,0,0
2009-04-01,0.71,1273442,899564,2173006,0,0,0
2009-04-02,0.59,2099113,1240331,3339444,0,0,0
2009-04-03,0.67,1509298,1017119,2526417,0,0,0
2009-04-06,0.68,1245974,844363,2090337,0,0,0
2009-04-07,0.8,1302366,1044978,2347344,0,0,0
2009-04-08,0.66,1407934,923585,2331519,0,0,0
2009-04-09,0.56,2305816,1298196,3604012,0,0,0
2009-04-13,0.51,2393405,1219880,3613285,0,0,0
2009-04-14,0.57,2553851,1455699,4009550,0,0,0
2009-04-15,0.61,1972587,1193465,3166052,0,0,0
2009-04-16,0.6,2460787,1471547,3932334,0,0,0
2009-04-17,0.55,2958517,1640222,4598739,0,0,0
2009-04-20,0.79,2103068,1670702,3773770,0,0,0
2009-04-21,0.67,1847620,1228829,3076449,0,0,0
2009-04-22,0.64,1934572,1240446,3175018,0,0,0
2009-04-23,0.73,1526897,1112740,2639637,0,0,0
2009-04-24,0.67,1727367,1157182,2884549,0,0,0
2009-04-27,0.65,1738970,1133861,2872831,0,0,0
2009-04-28,0.73,1549898,1131795,2681693,0,0,0
2009-04-29,0.63,1564781,982088,2546869,0,0,0
2009-04-30,0.64,1804634,1153306,2957940,0,0,0
2009-05-01,0.61,1371791,832069,2203860,0,0,0
2009-05-04,0.54,2063476,1122302,3185778,0,0,0
2009-05-05,0.59,1758167,1030504,2788671,0,0,0
2009-05-06,0.59,2633006,1540412,4173418,0,0,0
2009-05-07,0.67,2708646,1819998,4528644,0,0,0
2009-05-08,0.62,2395502,1477550,3873052,0,0,0
2009-05-11,0.63,1845898,1164357,3010255,0,0,0
2009-05-12,0.67,2061626,1384425,3446051,0,0,0
2009-05-13,0.67,2019107,1351616,3370723,0,0,0
2009-05-14,0.62,1830615,1130694,2961309,0,0,0
2009-05-15,0.63,1898642,1197239,3095881,0,0,0
2009-05-18,0.55,1666226,918223,2584449,0,0,0
2009-05-19,0.62,1533396,956195,2489591,0,0,0
2009-05-20,0.63,1816015,1152230,2968245,0,0,0
2009-05-21,0.8,1408335,1126158,2534493,0,0,0
2009-05-22,0.63,1167822,736827,1904649,0,0,0
2009-05-26,0.54,1475386,798595,2273981,0,0,0
2009-05-27,0.71,1375594,979443,2355037,0,0,0
2009-05-28,0.61,1569223,960797,2530020,0,0,0
2009-05-29,0.63,1385999,876896,2262895,0,0,0
2009-06-01,0.56,2093135,1177181,3270316,0,0,0
2009-06-02,0.63,1524087,961264,2485351,0,0,0
2009-06-03,0.76,1319046,1003668,2322714,0,0,0
2009-06-04,0.63,1445426,910306,2355732,0,0,0
2009-06-05,0.6,1436167,861078,2297245,0,0,0
2009-06-08,0.75,1176544,883672,2060216,0,0,0
2009-06-09,0.66,1358635,899132,2257767,0,0,0
2009-06-10,0.72,1436674,1036557,2473231,0,0,0
2009-06-11,0.55,1756471,965395,2721866,0,0,0
2009-06-12,0.65,1436654,934771,2371425,0,0,0
2009-06-15,0.6,1617341,967507,2584848,0,0,0
2009-06-16,0.8,1389736,1108844,2498580,0,0,0
2009-06-17,0.89,1722387,1533641,3256028,0,0,0
2009-06-18,0.77,1490271,1144535,2634806,0,0,0
2009-06-19,0.65,2002246,1299064,3301310,0,0,0
2009-06-22,0.72,1410091,1021430,2431521,0,0,0
2009-06-23,0.77,1238206,948975,2187181,0,0,0
2009-06-24,0.62,1186068,736978,1923046,0,0,0
2009-06-25,0.75,1093439,818402,1911841,0,0,0
2009-06-26,0.71,945218,668993,1614211,0,0,0
2009-06-29,0.72,865313,626463,1491776,0,0,0
2009-06-30,0.83,919621,759518,1679139,0,0,0
2009-07-01,0.73,883391,648482,1531873,0,0,0
2009-07-02,0.72,988877,707096,1695973,0,0,0
2009-07-06,0.73,1129520,824841,1954361,0,0,0
2009-07-07,0.86,1083593,931619,2015212,0,0,0
2009-07-08,0.86,1407033,1208051,2615084,0,0,0
2009-07-09,0.79,1013219,803621,1816840,0,0,0
2009-07-10,0.77,1018148,783471,1801619,0,0,0
2009-07-13,0.69,1350760,925748,2276508,0,0,0
2009-07-14,0.77,1223391,947394,2170785,0,0,0
2009-07-15,0.61,2136914,1313043,3449957,0,0,0
2009-07-16,0.61,1993617,1209800,3203417,0,0,0
2009-07-17,0.57,2484464,1423685,3908149,0,0,0
2009-07-20,0.6,1990230,1197386,3187616,0,0,0
2009-07-21,0.61,1544718,942693,2487411,0,0,0
2009-07-22,0.68,1393927,942481,2336408,0,0,0
2009-07-23,0.66,1912221,1269858,3182079,0,0,0
2009-07-24,0.78,1299828,1014072,2313900,0,0,0
2009-07-27,0.54,1310069,705151,2015220,0,0,0
2009-07-28,0.64,1493096,948721,2441817,0,0,0
2009-07-29,0.62,1407056,873706,2280762,0,0,0
2009-07-30,0.51,2277048,1150810,3427858,0,0,0
2009-07-31,0.65,1281375,835845,2117220,0,0,0
2009-08-03,0.62,1616843,997889,2614732,0,0,0
2009-08-04,0.58,1531070,881340,2412410,0,0,0
2009-08-05,0.52,2083614,1073078,3156692,0,0,0
2009-08-06,0.66,1661167,1104430,2765597,0,0,0
2009-08-07,0.49,2219243,1083940,3303183,0,0,0
2009-08-10,0.56,1431739,806445,2238184,0,0,0
2009-08-11,0.64,1673499,1078042,2751541,0,0,0
2009-08-12,0.6,1516281,912805,2429086,0,0,0
2009-08-13,0.51,1639190,833766,2472956,0,0,0
2009-08-14,0.59,1357174,806399,2163573,0,0,0
2009-08-17,0.71,1366925,964779,2331704,0,0,0
2009-08-18,0.63,1374442,866931,2241373,0,0,0
2009-08-19,0.62,1584221,982897,2567118,0,0,0
2009-08-20,0.5,1861175,936086,2797261,0,0,0
2009-08-21,0.39,2498097,974371,3472468,0,0,0
2009-08-24,0.52,2001850,1042470,3044320,0,0,0
2009-08-25,0.59,1477666,878808,2356474,0,0,0
2009-08-26,0.64,1246492,802057,2048549,0,0,0
2009-08-27,0.59,1688124,996694,2684818,0,0,0
2009-08-28,0.58,1762584,1020595,2783179,0,0,0
2009-08-31,0.63,1278630,804287,2082917,0,0,0
2009-09-01,0.69,1817293,1245931,3063224,0,0,0
2009-09-02,0.69,1451183,1000321,2451504,0,0,0
2009-09-03,0.6,1304042,778743,2082785,0,0,0
2009-09-04,0.59,1156758,683945,1840703,0,0,0
2009-09-08,0.59,1514364,886121,2400485,0,0,0
2009-09-09,0.54,1559424,837241,2396665,0,0,0
2009-09-10,0.61,1562138,958184,2520322,0,0,0
2009-09-11,0.61,1570454,959692,2530146,0,0,0
2009-09-14,0.55,1678649,927960,2606609,0,0,0
2009-09-15,0.56,2189350,1234886,3424236,0,0,0
2009-09-16,0.46,2656900,1212858,3869758,0,0,0
2009-09-17,0.53,2656069,1398624,4054693,0,0,0
2009-09-18,0.56,2064164,1159613,3223777,0,0,0
2009-09-21,0.64,1476297,943434,2419731,0,0,0
2009-09-22,0.55,1645037,904148,2549185,0,0,0
2009-09-23,0.6,2069855,1249028,3318883,0,0,0
2009-09-24,0.71,1468348,1049246,2517594,0,0,0
2009-09-25,0.58,1284158,742663,2026821,0,0,0
2009-09-28,0.6,942097,560561,1502658,0,0,0
2009-09-29,0.61,1134984,692236,1827220,0,0,0
2009-09-30,0.73,1348669,989954,2338623,0,0,0
2009-10-01,0.73,1484020,1090378,2574398,0,0,0
2009-10-02,0.85,1516940,1293644,2810584,0,0,0
2009-10-05,0.56,1284856,716008,2000864,0,0,0
2009-10-06,0.48,1763206,849576,2612782,0,0,0
2009-10-07,0.51,1368857,698659,2067516,0,0,0
2009-10-08,0.53,1807979,955037,2763016,0,0,0
2009-10-09,0.55,1421779,783115,2204894,0,0,0
2009-10-12,0.56,1406386,781538,2187924,0,0,0
2009-10-13,0.56,1591512,895782,2487294,0,0,0
2009-10-14,0.47,2199276,1029066,3228342,0,0,0
2009-10-15,0.46,2229907,1030774,3260681,0,0,0
2009-10-16,0.54,2446545,1332022,3778567,0,0,0
2009-10-19,0.61,1719103,1046607,2765710,0,0,0
2009-10-20,0.67,1490628,1002671,2493299,0,0,0
2009-10-21,0.55,1882869,1042039,2924908,0,0,0
2009-10-22,0.6,1517159,911992,2429151,0,0,0
2009-10-23,0.64,1383381,879095,2262476,0,0,0
2009-10-26,0.65,1536955,993788,2530743,0,0,0
2009-10-27,0.62,1400414,868110,2268524,0,0,0
2009-10-28,0.69,1682297,1164893,2847190,0,0,0
2009-10-29,0.53,1437819,763740,2201559,0,0,0
2009-10-30,0.8,1453948,1158644,2612592,0,0,0
2009-11-02,0.79,1571420,1241901,2813321,0,0,0
2009-11-03,0.69,1342752,932373,2275125,0,0,0
2009-11-04,0.57,1458620,836696,2295316,0,0,0
2009-11-05,0.64,1280040,813108,2093148,0,0,0
2009-11-06,0.64,1173402,746176,1919578,0,0,0
2009-11-09,0.53,1561070,829523,2390593,0,0,0
2009-11-10,0.57,1224614,701601,1926215,0,0,0
2009-11-11,0.51,1419011,730586,2149597,0,0,0
2009-11-12,0.58,1138961,665511,1804472,0,0,0
2009-11-13,0.62,1116343,691648,1807991,0,0,0
2009-11-16,0.56,1521622,852036,2373658,0,0,0
2009-11-17,0.66,1444304,954330,2398634,0,0,0
2009-11-18,0.59,1518959,888900,2407859,0,0,0
2009-11-19,0.73,1352659,993774,2346433,0,0,0
2009-11-20,0.66,1665710,1101992,2767702,0,0,0
2009-11-23,0.55,1587717,872286,2460003,0,0,0
2009-11-24,0.64,1167497,751696,1919193,0,0,0
2009-11-25,0.61,960773,586251,1547024,0,0,0
2009-11-27,0.77,635251,488920,1124171,0,0,0
2009-11-30,0.77,991732,768008,1759740,0,0,0
2009-12-01,0.56,1372674,769856,2142530,0,0,0
2009-12-02,0.55,1303166,720038,2023204,0,0,0
2009-12-03,0.61,1439275,882192,2321467,0,0,0
2009-12-04,0.66,1650666,1092923,2743589,0,0,0
2009-12-07,0.65,1199080,782458,1981538,0,0,0
2009-12-08,0.63,1438064,903358,2341422,0,0,0
2009-12-09,0.56,1295875,728544,2024419,0,0,0
2009-12-10,0.6,1328958,802940,2131898,0,0,0
2009-12-11,0.6,1259776,752577,2012353,0,0,0
2009-12-14,0.61,1486322,905896,2392218,0,0,0
2009-12-15,0.58,1883872,1091699,2975571,0,0,0
2009-12-16,0.65,1809825,1175502,2985327,0,0,0
2009-12-17,0.67,1940194,1296645,3236839,0,0,0
2009-12-18,0.67,1844244,1233917,3078161,0,0,0
2009-12-21,0.5,1491457,747234,2238691,0,0,0
2009-12-22,0.65,1176894,768583,1945477,0,0,0
2009-12-23,0.59,1200615,704282,1904897,0,0,0
2009-12-24,0.49,664160,322153,986313,0,0,0
2009-12-28,0.53,1044895,548716,1593611,0,0,0
2009-12-29,0.59,951100,565039,1516139,0,0,0
2009-12-30,0.59,870513,515095,1385608,0,0,0
2009-12-31,0.59,794567,470891,1265458,0,0,0
2010-01-04,0.48,1587805,769863,2357668,0,0,0
2010-01-05,0.55,1848688,1012760,2861448,0,0,0
2010-01-06,0.5,1665246,840036,2505282,0,0,0
2010-01-07,0.48,2006453,960442,2966895,0,0,0
2010-01-08,0.46,1817851,835511,2653362,0,0,0
2010-01-11,0.46,1816552,841503,2658055,0,0,0
2010-01-12,0.58,1872801,1077423,2950224,0,0,0
2010-01-13,0.55,1707280,930506,2637786,0,0,0
2010-01-14,0.53,1859299,978986,2838285,0,0,0
2010-01-15,0.58,2248181,1307358,3555539,0,0,0
2010-01-19,0.56,1703809,955803,2659612,0,0,0
2010-01-20,0.66,1494164,991546,2485710,0,0,0
2010-01-21,0.7,1826546,1282314,3108860,0,0,0
2010-01-22,0.75,1676992,1262928,2939920,0,0,0
2010-01-25,0.64,1230291,784849,2015140,0,0,0
2010-01-26,0.65,1486284,964785,2451069,0,0,0
2010-01-27,0.67,1301470,877324,2178794,0,0,0
2010-01-28,0.65,1372045,887894,2259939,0,0,0
2010-01-29,0.73,1350908,981046,2331954,0,0,0
2010-02-01,0.58,1120867,652412,1773279,0,0,0
2010-02-02,0.58,1392962,808858,2201820,0,0,0
2010-02-03,0.64,1263334,812404,2075738,0,0,0
2010-02-04,0.78,1491045,1164302,2655347,0,0,0
2010-02-05,0.78,1418561,1111989,2530550,0,0,0
2010-02-08,0.7,910735,640567,1551302,0,0,0
2010-02-09,0.71,1195771,853145,2048916,0,0,0
2010-02-10,0.63,1034055,653729,1687784,0,0,0
2010-02-11,0.73,1144102,839582,1983684,0,0,0
2010-02-12,0.61,1075149,652995,1728144,0,0,0
2010-02-16,0.63,1371100,865981,2237081,0,0,0
2010-02-17,0.61,1407049,861856,2268905,0,0,0
2010-02-18,0.67,1452837,970309,2423146,0,0,0
2010-02-19,0.66,1562444,1038910,2601354,0,0,0
2010-02-22,0.6,1371452,825257,2196709,0,0,0
2010-02-23,0.78,1228126,954065,2182191,0,0,0
2010-02-24,0.67,1204798,804868,2009666,0,0,0
2010-02-25,0.81,1013162,825254,1838416,0,0,0
2010-02-26,0.68,913489,623640,1537129,0,0,0
2010-03-01,0.58,1215633,703498,1919131,0,0,0
2010-03-02,0.6,1474115,881045,2355160,0,0,0
2010-03-03,0.65,1199501,774022,1973523,0,0,0
2010-03-04,0.66,1233632,812456,2046088,0,0,0
2010-03-05,0.52,1551820,807190,2359010,0,0,0
2010-03-08,0.51,1441861,734882,2176743,0,0,0
2010-03-09,0.46,2072336,953166,3025502,0,0,0
2010-03-10,0.52,2142961,1105069,3248030,0,0,0
2010-03-11,0.53,1615499,858471,2473970,0,0,0
2010-03-12,0.51,1655196,841971,2497167,0,0,0
2010-03-15,0.56,1346752,759500,2106252,0,0,0
2010-03-16,0.52,1755785,909437,2665222,0,0,0
2010-03-17,0.49,2031293,1002572,3033865,0,0,0
2010-03-18,0.53,1545661,826696,2372357,0,0,0
2010-03-19,0.6,1921689,1157955,3079644,0,0,0
2010-03-22,0.53,1550170,819697,2369867,0,0,0
2010-03-23,0.58,1636826,946877,2583703,0,0,0
2010-03-24,0.64,1498574,963795,2462369,0,0,0
2010-03-25,0.49,1855080,907600,2762680,0,0,0
2010-03-26,0.65,1452191,942088,2394279,0,0,0
2010-03-29,0.64,1487837,949158,2436995,0,0,0
2010-03-30,0.53,1195591,629599,1825190,0,0,0
2010-03-31,0.51,1367789,697688,2065477,0,0,0
2010-04-01,0.51,1256230,636149,1892379,0,0,0
2010-04-05,0.43,1328954,572678,1901632,0,0,0
2010-04-06,0.44,1690913,742449,2433362,0,0,0
2010-04-07,0.57,1779436,1018956,2798392,0,0,0
2010-04-08,0.46,1616774,746769,2363543,0,0,0
2010-04-09,0.48,1680902,803503,2484405,0,0,0
2010-04-12,0.4,2016288,806009,2822297,0,0,0
2010-04-13,0.48,1930766,935973,2866739,0,0,0
2010-04-14,0.32,3137687,1017578,4155265,0,0,0
2010-04-15,0.36,3080508,1110111,4190619,0,0,0
2010-04-16,0.52,3325895,1739952,5065847,0,0,0
2010-04-19,0.5,2229200,1123448,3352648,0,0,0
2010-04-20,0.51,1905312,975078,2880390,0,0,0
2010-04-21,0.52,1996603,1045798,3042401,0,0,0
2010-04-22,0.51,1890742,967868,2858610,0,0,0
2010-04-23,0.48,1804973,864707,2669680,0,0,0
2010-04-26,0.42,2054234,852665,2906899,0,0,0
2010-04-27,0.57,2085895,1199315,3285210,0,0,0
2010-04-28,0.53,1788290,945988,2734278,0,0,0
2010-04-29,0.49,1843390,906214,2749604,0,0,0
2010-04-30,0.61,1777140,1088069,2865209,0,0,0
2010-05-03,0.53,1781450,952849,2734299,0,0,0
2010-05-04,0.68,2022860,1373025,3395885,0,0,0
2010-05-05,0.7,1929849,1349587,3279436,0,0,0
2010-05-06,0.72,2799542,2020646,4820188,0,0,0
2010-05-07,0.8,2271647,1819858,4091505,0,0,0
2010-05-10,0.62,1708332,1061335,2769667,0,0,0
2010-05-11,0.69,1419002,981556,2400558,0,0,0
2010-05-12,0.51,1623205,830295,2453500,0,0,0
2010-05-13,0.56,1521892,859524,2381416,0,0,0
2010-05-14,0.73,1708882,1244936,2953818,0,0,0
2010-05-17,0.7,1523947,1060537,2584484,0,0,0
2010-05-18,0.64,1596359,1028488,2624847,0,0,0
2010-05-19,0.82,1614102,1329170,2943272,0,0,0
2010-05-20,0.91,1954119,1769082,3723201,0,0,0
2010-05-21,0.87,2211275,1921214,4132489,0,0,0
2010-05-24,0.62,1314743,813586,2128329,0,0,0
2010-05-25,0.66,1505026,988431,2493457,0,0,0
2010-05-26,0.53,1595275,853172,2448447,0,0,0
2010-05-27,0.5,1343622,674286,2017908,0,0,0
2010-05-28,0.58,922994,539673,1462667,0,0,0
2010-06-01,0.61,1048585,641364,1689949,0,0,0
2010-06-02,0.63,1274581,803148,2077729,0,0,0
2010-06-03,0.59,1171913,694691,1866604,0,0,0
2010-06-04,0.6,1263843,761589,2025432,0,0,0
2010-06-07,0.6,1222103,729132,1951235,0,0,0
2010-06-08,0.7,1164630,819951,1984581,0,0,0
2010-06-09,0.74,1298668,955597,2254265,0,0,0
2010-06-10,0.66,1266763,838074,2104837,0,0,0
2010-06-11,0.7,881281,617168,1498449,0,0,0
2010-06-14,0.7,1041264,733729,1774993,0,0,0
2010-06-15,0.56,1396451,780521,2176972,0,0,0
2010-06-16,0.66,1248455,826738,2075193,0,0,0
2010-06-17,0.71,1194477,847137,2041614,0,0,0
2010-06-18,0.62,1501787,930745,2432532,0,0,0
2010-06-21,0.54,1479427,794824,2274251,0,0,0
2010-06-22,0.63,1047080,659424,1706504,0,0,0
2010-06-23,0.71,837873,592391,1430264,0,0,0
2010-06-24,0.82,1018603,834175,1852778,0,0,0
2010-06-25,0.63,1042837,655988,1698825,0,0,0
2010-06-28,0.66,831083,544939,1376022,0,0,0
2010-06-29,0.8,1304535,1043209,2347744,0,0,0
2010-06-30,0.62,1026119,633363,1659482,0,0,0
2010-07-01,0.75,1350025,1016637,2366662,0,0,0
2010-07-02,0.6,825835,492465,1318300,0,0,0
2010-07-06,0.61,992224,609950,1602174,0,0,0
2010-07-07,0.52,1150190,602882,1753072,0,0,0
2010-07-08,0.56,1128367,626983,1755350,0,0,0
2010-07-09,0.58,1117866,650209,1768075,0,0,0
2010-07-12,0.61,1103765,671428,1775193,0,0,0
2010-07-13,0.49,1856555,918374,2774929,0,0,0
2010-07-14,0.56,1385771,779158,2164929,0,0,0
2010-07-15,0.61,1357959,832646,2190605,0,0,0
2010-07-16,0.74,1750843,1301934,3052777,0,0,0
2010-07-19,0.51,1483144,757934,2241078,0,0,0
2010-07-20,0.51,1321755,679589,2001344,0,0,0
2010-07-21,0.63,1226396,775665,2002061,0,0,0
2010-07-22,0.52,1512658,781835,2294493,0,0,0
2010-07-23,0.55,1200814,663213,1864027,0,0,0
2010-07-26,0.53,1166761,621289,1788050,0,0,0
2010-07-27,0.52,1387879,724137,2112016,0,0,0
2010-07-28,0.7,979689,682090,1661779,0,0,0
2010-07-29,0.65,1208333,787143,1995476,0,0,0
2010-07-30,0.61,897030,548857,1445887,0,0,0
2010-08-02,0.56,1253509,706725,1960234,0,0,0
2010-08-03,0.6,1117125,665751,1782876,0,0,0
2010-08-04,0.56,1240501,692373,1932874,0,0,0
2010-08-05,0.61,1055946,648185,1704131,0,0,0
2010-08-06,0.58,1005016,582553,1587569,0,0,0
2010-08-09,0.56,886850,499994,1386844,0,0,0
2010-08-10,0.63,982003,615069,1597072,0,0,0
2010-08-11,0.75,1226949,914829,2141778,0,0,0
2010-08-12,0.61,1196185,731623,1927808,0,0,0
2010-08-13,0.66,789784,519895,1309679,0,0,0
2010-08-16,0.7,849286,596616,1445902,0,0,0
2010-08-17,0.62,1150450,718659,1869109,0,0,0
2010-08-18,0.67,1118031,743521,1861552,0,0,0
2010-08-19,0.71,1226333,865901,2092234,0,0,0
2010-08-20,0.73,1369099,992715,2361814,0,0,0
2010-08-23,0.4,1585527,629755,2215282,0,0,0
2010-08-24,0.73,1103177,807142,1910319,0,0,0
2010-08-25,0.61,1110123,672091,1782214,0,0,0
2010-08-26,0.62,865809,538041,1403850,0,0,0
2010-08-27,0.56,1029677,575383,1605060,0,0,0
2010-08-30,0.58,714397,414541,1128938,0,0,0
2010-08-31,0.74,829840,617452,1447292,0,0,0
2010-09-01,0.48,1285242,623299,1908541,0,0,0
2010-09-02,0.55,1095596,602143,1697739,0,0,0
2010-09-03,0.56,992145,552964,1545109,0,0,0
2010-09-07,0.61,820489,497177,1317666,0,0,0
2010-09-08,0.54,1041102,557113,1598215,0,0,0
2010-09-09,0.6,968615,577094,1545709,0,0,0
2010-09-10,0.66,847056,558086,1405142,0,0,0
2010-09-13,0.52,1320548,681731,2002279,0,0,0
2010-09-14,0.59,1333792,786219,2120011,0,0,0
2010-09-15,0.56,1321196,738436,2059632,0,0,0
2010-09-16,0.58,1226860,712371,1939231,0,0,0
2010-09-17,0.59,1619836,957104,2576940,0,0,0
2010-09-20,0.48,1596408,763246,2359654,0,0,0
2010-09-21,0.6,1289690,776939,2066629,0,0,0
2010-09-22,0.73,1118616,818541,1937157,0,0,0
2010-09-23,0.63,1163094,730682,1893776,0,0,0
2010-09-24,0.53,1290201,689125,1979326,0,0,0
2010-09-27,0.57,995050,566975,1562025,0,0,0
2010-09-28,0.59,1114981,657261,1772242,0,0,0
2010-09-29,0.54,1257674,677089,1934763,0,0,0
2010-09-30,0.52,1252242,655807,1908049,0,0,0
2010-10-01,0.54,1158716,624391,1783107,0,0,0
2010-10-04,0.59,1043586,614720,1658306,0,0,0
2010-10-05,0.54,1409761,755062,2164823,0,0,0
2010-10-06,0.58,1349182,782339,2131521,0,0,0
2010-10-07,0.66,1168540,772892,1941432,0,0,0
2010-10-08,0.55,1391012,769187,2160199,0,0,0
2010-10-11,0.57,1301816,736816,2038632,0,0,0
2010-10-12,0.51,1330857,682809,2013666,0,0,0
2010-10-13,0.45,2057175,916759,2973934,0,0,0
2010-10-14,0.57,2069767,1177435,3247202,0,0,0
2010-10-15,0.56,2242650,1246617,3489267,0,0,0
2010-10-18,0.56,1694556,950777,2645333,0,0,0
2010-10-19,0.74,1476872,1088126,2564998,0,0,0
2010-10-20,0.66,1426512,942522,2369034,0,0,0
2010-10-21,0.72,1228606,882854,2111460,0,0,0
2010-10-22,0.68,1036808,710021,1746829,0,0,0
2010-10-25,0.63,1310491,827269,2137760,0,0,0
2010-10-26,0.6,1414258,842555,2256813,0,0,0
2010-10-27,0.62,1443792,893774,2337566,0,0,0
2010-10-28,0.6,1438852,864471,2303323,0,0,0
2010-10-29,0.54,1287894,695831,1983725,0,0,0
2010-11-01,0.63,1268821,795456,2064277,0,0,0
2010-11-02,0.54,1218760,658374,1877134,0,0,0
2010-11-03,0.52,1512803,788771,2301574,0,0,0
2010-11-04,0.44,2465210,1086621,3551831,0,0,0
2010-11-05,0.41,2398237,980204,3378441,0,0,0
2010-11-08,0.5,1544815,773734,2318549,0,0,0
2010-11-09,0.56,1724887,960776,2685663,0,0,0
2010-11-10,0.47,1555458,736538,2291996,0,0,0
2010-11-11,0.55,1580487,866130,2446617,0,0,0
2010-11-12,0.63,1632803,1034598,2667401,0,0,0
2010-11-15,0.55,1464588,798644,2263232,0,0,0
2010-11-16,0.66,1701132,1127325,2828457,0,0,0
2010-11-17,0.56,1452097,813984,2266081,0,0,0
2010-11-18,0.53,1651029,878785,2529814,0,0,0
2010-11-19,0.56,1819150,1018951,2838101,0,0,0
2010-11-22,0.56,1458376,819018,2277394,0,0,0
2010-11-23,0.7,1225284,859963,2085247,0,0,0
2010-11-24,0.53,1063199,561210,1624409,0,0,0
2010-11-26,0.64,470043,300576,770619,0,0,0
2010-11-29,0.7,1048779,733161,1781940,0,0,0
2010-11-30,0.57,1193209,685579,1878788,0,0,0
2010-12-01,0.45,1475462,666446,2141908,0,0,0
2010-12-02,0.45,1705176,759991,2465167,0,0,0
2010-12-03,0.5,1323925,664203,1988128,0,0,0
2010-12-06,0.49,1355436,666289,2021725,0,0,0
2010-12-07,0.45,1914723,853819,2768542,0,0,0
2010-12-08,0.47,1541289,721356,2262645,0,0,0
2010-12-09,0.43,1754805,748325,2503130,0,0,0
2010-12-10,0.42,1668032,692414,2360446,0,0,0
2010-12-13,0.35,2117713,746240,2863953,0,0,0
2010-12-14,0.5,1598614,795552,2394166,0,0,0
2010-12-15,0.51,1562541,802935,2365476,0,0,0
2010-12-16,0.5,1709025,850214,2559239,0,0,0
2010-12-17,0.49,1858691,913426,2772117,0,0,0
2010-12-20,0.58,1549684,896487,2446171,0,0,0
2010-12-21,0.5,1427739,715823,2143562,0,0,0
2010-12-22,0.47,1338242,632901,1971143,0,0,0
2010-12-23,0.52,1002635,521165,1523800,0,0,0
2010-12-27,0.53,841684,447711,1289395,0,0,0
2010-12-28,0.55,963168,525575,1488743,0,0,0
2010-12-29,0.52,928357,481796,1410153,0,0,0
2010-12-30,0.51,910799,464312,1375111,0,0,0
2010-12-31,0.7,723226,506202,1229428,0,0,0
2011-01-03,0.4,1979879,786089,2765968,0,0,0
2011-01-04,0.43,1852845,791707,2644552,0,0,0
2011-01-05,0.48,1852659,895116,2747775,0,0,0
2011-01-06,0.46,2137332,982089,3119421,0,0,0
2011-01-07,0.5,1936157,971971,2908128,0,0,0
2011-01-10,0.54,1428669,773350,2202019,0,0,0
2011-01-11,0.53,1598298,841165,2439463,0,0,0
2011-01-12,0.45,1865045,831412,2696457,0,0,0
2011-01-13,0.5,2037009,1018399,3055408,0,0,0
2011-01-14,0.37,2723031,1004895,3727926,0,0,0
2011-01-18,0.44,2318032,1016110,3334142,0,0,0
2011-01-19,0.47,2358646,1113296,3471942,0,0,0
2011-01-20,0.67,2151593,1432848,3584441,0,0,0
2011-01-21,0.55,2466693,1348891,3815584,0,0,0
2011-01-24,0.51,1785184,915357,2700541,0,0,0
2011-01-25,0.63,1695217,1072077,2767294,0,0,0
2011-01-26,0.58,1598700,919412,2518112,0,0,0
2011-01-27,0.56,1571963,877881,2449844,0,0,0
2011-01-28,0.65,1707963,1114679,2822642,0,0,0
2011-01-31,0.61,1370723,837545,2208268,0,0,0
2011-02-01,0.49,1844674,904381,2749055,0,0,0
2011-02-02,0.45,1711054,778446,2489500,0,0,0
2011-02-03,0.58,1609801,937466,2547267,0,0,0
2011-02-04,0.64,1455715,934249,2389964,0,0,0
2011-02-07,0.46,1695546,774393,2469939,0,0,0
2011-02-08,0.52,1472659,762444,2235103,0,0,0
2011-02-09,0.52,1613773,843142,2456915,0,0,0
2011-02-10,0.55,1833821,1015179,2849000,0,0,0
2011-02-11,0.51,1918427,983702,2902129,0,0,0
2011-02-14,0.51,1654462,851724,2506186,0,0,0
2011-02-15,0.53,1483604,791221,2274825,0,0,0
2011-02-16,0.58,1812707,1045902,2858609,0,0,0
2011-02-17,0.5,1846313,928669,2774982,0,0,0
2011-02-18,0.61,1958313,1191706,3150019,0,0,0
2011-02-22,0.68,1817321,1237376,3054697,0,0,0
2011-02-23,0.72,1822930,1310392,3133322,0,0,0
2011-02-24,0.71,1400155,989406,2389561,0,0,0
2011-02-25,0.49,1387325,683836,2071161,0,0,0
2011-02-28,0.53,1247689,666797,1914486,0,0,0
2011-03-01,0.64,1335116,857859,2192975,0,0,0
2011-03-02,0.55,1202768,666213,1868981,0,0,0
2011-03-03,0.55,1318148,719369,2037517,0,0,0
2011-03-04,0.57,1416865,802282,2219147,0,0,0
2011-03-07,0.64,1276233,815715,2091948,0,0,0
2011-03-08,0.54,1339628,726328,2065956,0,0,0
2011-03-09,0.6,1188077,716388,1904465,0,0,0
2011-03-10,0.73,1424462,1035358,2459820,0,0,0
2011-03-11,0.62,1086201,670492,1756693,0,0,0
2011-03-14,0.67,1119528,746499,1866027,0,0,0
2011-03-15,0.71,1629510,1158065,2787575,0,0,0
2011-03-16,0.79,1645815,1296965,2942780,0,0,0
2011-03-17,0.71,1283074,916231,2199305,0,0,0
2011-03-18,0.67,1742494,1163581,2906075,0,0,0
2011-03-21,0.49,1717392,839086,2556478,0,0,0
2011-03-22,0.55,1218554,666502,1885056,0,0,0
2011-03-23,0.59,1243053,728245,1971298,0,0,0
2011-03-24,0.55,1506152,830078,2336230,0,0,0
2011-03-25,0.53,1368197,726168,2094365,0,0,0
2011-03-28,0.56,1030144,573303,1603447,0,0,0
2011-03-29,0.52,1126947,590117,1717064,0,0,0
2011-03-30,0.54,1335217,719441,2054658,0,0,0
2011-03-31,0.56,1185880,666189,1852069,0,0,0
2011-04-01,0.51,1393132,715155,2108287,0,0,0
2011-04-04,0.59,1102876,656085,1758961,0,0,0
2011-04-05,0.56,1290943,728319,2019262,0,0,0
2011-04-06,0.55,1463009,802878,2265887,0,0,0
2011-04-07,0.53,1309691,694187,2003878,0,0,0
2011-04-08,0.58,1288997,750120,2039117,0,0,0
2011-04-11,0.62,1174919,726657,1901576,0,0,0
2011-04-12,0.58,1449671,847799,2297470,0,0,0
2011-04-13,0.65,1231881,804104,2035985,0,0,0
2011-04-14,0.69,1354442,938073,2292515,0,0,0
2011-04-15,0.63,1636189,1031676,2667865,0,0,0
2011-04-18,0.6,1356782,819082,2175864,0,0,0
2011-04-19,0.64,1269775,808942,2078717,0,0,0
2011-04-20,0.51,1659896,839010,2498906,0,0,0
2011-04-21,0.62,1383910,855488,2239398,0,0,0
2011-04-25,0.57,1046726,596273,1642999,0,0,0
2011-04-26,0.57,1239201,700557,1939758,0,0,0
2011-04-27,0.59,1305153,767331,2072484,0,0,0
2011-04-28,0.54,1346839,731671,2078510,0,0,0
2011-04-29,0.59,1251355,735029,1986384,0,0,0
2011-05-02,0.5,1243294,620297,1863591,0,0,0
2011-05-03,0.61,1466498,901250,2367748,0,0,0
2011-05-04,0.72,1343469,971595,2315064,0,0,0
2011-05-05,0.65,1257282,812406,2069688,0,0,0
2011-05-06,0.62,1120193,695537,1815730,0,0,0
2011-05-09,0.63,891594,559235,1450829,0,0,0
2011-05-10,0.58,1019632,590135,1609767,0,0,0
2011-05-11,0.67,1159917,774163,1934080,0,0,0
2011-05-12,0.67,1199680,801786,2001466,0,0,0
2011-05-13,0.73,1043134,765507,1808641,0,0,0
2011-05-16,0.61,1167069,711720,1878789,0,0,0
2011-05-17,0.75,1184442,889123,2073565,0,0,0
2011-05-18,0.68,1084862,737676,1822538,0,0,0
2011-05-19,0.7,1096376,770325,1866701,0,0,0
2011-05-20,0.75,1270924,955801,2226725,0,0,0
2011-05-23,0.69,941533,645216,1586749,0,0,0
2011-05-24,0.61,1026091,627313,1653404,0,0,0
2011-05-25,0.51,1190691,603221,1793912,0,0,0
2011-05-26,0.6,860806,517165,1377971,0,0,0
2011-05-27,0.51,989075,502010,1491085,0,0,0
2011-05-31,0.54,932803,500324,1433127,0,0,0
2011-06-01,0.76,1035050,787098,1822148,0,0,0
2011-06-02,0.71,871294,620450,1491744,0,0,0
2011-06-03,0.71,887773,631674,1519447,0,0,0
2011-06-06,0.8,1048033,833233,1881266,0,0,0
2011-06-07,0.74,877042,647898,1524940,0,0,0
2011-06-08,0.95,1001729,953937,1955666,0,0,0
2011-06-09,0.77,868295,665415,1533710,0,0,0
2011-06-10,1.01,905696,913005,1818701,0,0,0
2011-06-13,0.73,960084,704242,1664326,0,0,0
2011-06-14,0.65,956788,618075,1574863,0,0,0
2011-06-15,1.09,858990,940136,1799126,0,0,0
2011-06-16,1.03,1009203,1037954,2047157,0,0,0
2011-06-17,1.09,1152676,1252862,2405538,0,0,0
2011-06-20,0.57,1133605,642043,1775648,0,0,0
2011-06-21,0.59,1190106,702244,1892350,0,0,0
2011-06-22,0.53,933191,493334,1426525,0,0,0
2011-06-23,0.65,1078072,703409,1781481,0,0,0
2011-06-24,0.7,754027,526519,1280546,0,0,0
2011-06-27,0.62,870362,540380,1410742,0,0,0
2011-06-28,0.59,990175,585733,1575908,0,0,0
2011-06-29,0.56,946495,529856,1476351,0,0,0
2011-06-30,0.54,1088428,591462,1679890,0,0,0
2011-07-01,0.55,1085173,598387,1683560,0,0,0
2011-07-05,0.64,914351,585741,1500092,0,0,0
2011-07-06,0.71,876401,626618,1503019,0,0,0
2011-07-07,0.56,1262960,705628,1968588,0,0,0
2011-07-08,0.58,954463,553723,1508186,0,0,0
2011-07-11,0.74,959005,707197,1666202,0,0,0
2011-07-12,0.67,962823,648786,1611609,0,0,0
2011-07-13,0.67,1018746,686897,1705643,0,0,0
2011-07-14,0.78,1091951,851982,1943933,0,0,0
2011-07-15,0.64,1366602,876194,2242796,0,0,0
2011-07-18,0.68,1195421,815330,2010751,0,0,0
2011-07-19,0.51,1548847,796024,2344871,0,0,0
2011-07-20,0.61,1248417,763229,2011646,0,0,0
2011-07-21,0.56,1523479,848604,2372083,0,0,0
2011-07-22,0.6,1106390,664559,1770949,0,0,0
2011-07-25,0.6,915889,550901,1466790,0,0,0
2011-07-26,0.58,1136339,663182,1799521,0,0,0
2011-07-27,0.66,1217433,807957,2025390,0,0,0
2011-07-28,0.68,1014479,694213,1708692,0,0,0
2011-07-29,0.77,1033702,795043,1828745,0,0,0
2011-08-01,0.76,879531,668565,1548096,0,0,0
2011-08-02,0.68,1030331,700017,1730348,0,0,0
2011-08-03,0.77,1229765,942236,2172001,0,0,0
2011-08-04,0.96,1533804,1475885,3009689,0,0,0
2011-08-05,0.94,1882146,1764051,3646197,0,0,0
2011-08-08,1.07,1707772,1831341,3539113,0,0,0
2011-08-09,0.85,1762353,1501897,3264250,0,0,0
2011-08-10,0.81,1382089,1123417,2505506,0,0,0
2011-08-11,0.62,1562348,964183,2526531,0,0,0
2011-08-12,0.75,1080987,811259,1892246,0,0,0
2011-08-15,0.68,1031339,703745,1735084,0,0,0
2011-08-16,0.74,925809,681887,1607696,0,0,0
2011-08-17,0.8,980607,787942,1768549,0,0,0
2011-08-18,0.96,1240018,1194385,2434403,0,0,0
2011-08-19,1.03,1140537,1171966,2312503,0,0,0
2011-08-22,0.73,1086848,789023,1875871,0,0,0
2011-08-23,0.67,1225963,817313,2043276,0,0,0
2011-08-24,0.66,962058,632255,1594313,0,0,0
2011-08-25,0.77,1017841,779339,1797180,0,0,0
2011-08-26,0.73,932503,678473,1610976,0,0,0
2011-08-29,0.54,1055904,566807,1622711,0,0,0
2011-08-30,0.72,897681,649103,1546784,0,0,0
2011-08-31,0.65,974960,635649,1610609,0,0,0
2011-09-01,0.69,780507,536197,1316704,0,0,0
2011-09-02,0.84,776392,652377,1428769,0,0,0
2011-09-06,0.75,895763,674670,1570433,0,0,0
2011-09-07,0.62,885007,548157,1433164,0,0,0
2011-09-08,0.71,851285,607613,1458898,0,0,0
2011-09-09,0.86,986021,846262,1832283,0,0,0
2011-09-12,0.72,903409,650545,1553954,0,0,0
2011-09-13,0.71,852422,601391,1453813,0,0,0
2011-09-14,0.64,1075941,690265,1766206,0,0,0
2011-09-15,0.68,1116484,757958,1874442,0,0,0
2011-09-16,0.67,1342088,897297,2239385,0,0,0
2011-09-19,0.62,975892,607288,1583180,0,0,0
2011-09-20,0.63,1022277,641977,1664254,0,0,0
2011-09-21,0.79,1079305,857244,1936549,0,0,0
2011-09-22,0.85,1412693,1199053,2611746,0,0,0
2011-09-23,0.65,1055580,681581,1737161,0,0,0
2011-09-26,0.59,966121,566150,1532271,0,0,0
2011-09-27,0.61,1040827,638436,1679263,0,0,0
2011-09-28,0.82,666546,549801,1216347,0,0,0
2011-09-29,0.8,831575,667444,1499019,0,0,0
2011-09-30,0.81,902876,729205,1632081,0,0,0
2011-10-03,0.85,1045038,892709,1937747,0,0,0
2011-10-04,0.77,1397537,1079044,2476581,0,0,0
2011-10-05,0.69,1105552,763528,1869080,0,0,0
2011-10-06,0.67,1020879,687272,1708151,0,0,0
2011-10-07,0.71,886783,626214,1512997,0,0,0
2011-10-10,0.63,887926,562934,1450860,0,0,0
2011-10-11,0.77,810183,619921,1430104,0,0,0
2011-10-12,0.64,1149998,732551,1882549,0,0,0
2011-10-13,0.71,866622,619571,1486193,0,0,0
2011-10-14,0.6,1118158,669482,1787640,0,0,0
2011-10-17,0.71,902843,644524,1547367,0,0,0
2011-10-18,0.62,1145034,708398,1853432,0,0,0
2011-10-19,0.71,1190326,850887,2041213,0,0,0
2011-10-20,0.74,1090286,803357,1893643,0,0,0
2011-10-21,0.5,1550969,782801,2333770,0,0,0
2011-10-24,0.52,1317299,687444,2004743,0,0,0
2011-10-25,0.79,930564,731790,1662354,0,0,0
2011-10-26,0.7,1052263,734397,1786660,0,0,0
2011-10-27,0.5,1896949,955015,2851964,0,0,0
2011-10-28,0.55,1174480,649004,1823484,0,0,0
2011-10-31,0.77,755662,585198,1340860,0,0,0
2011-11-01,0.89,1132530,1008268,2140798,0,0,0
2011-11-02,0.68,836582,569838,1406420,0,0,0
2011-11-03,0.63,996287,629911,1626198,0,0,0
2011-11-04,0.79,885145,701187,1586332,0,0,0
2011-11-07,0.65,770178,498171,1268349,0,0,0
2011-11-08,0.65,926980,604363,1531343,0,0,0
2011-11-09,0.91,1013555,921930,1935485,0,0,0
2011-11-10,0.75,906442,679280,1585722,0,0,0
2011-11-11,0.64,906589,583590,1490179,0,0,0
2011-11-14,0.77,752540,577336,1329876,0,0,0
2011-11-15,0.71,926606,654092,1580698,0,0,0
2011-11-16,0.74,922270,686416,1608686,0,0,0
2011-11-17,0.82,1102262,902700,2004962,0,0,0
2011-11-18,0.9,1062088,952478,2014566,0,0,0
2011-11-21,0.66,1094699,722881,1817580,0,0,0
2011-11-22,0.67,868038,577492,1445530,0,0,0
2011-11-23,0.71,927224,658775,1585999,0,0,0
2011-11-25,0.75,367019,275593,642612,0,0,0
2011-11-28,0.65,905868,587200,1493068,0,0,0
2011-11-29,0.61,865617,526369,1391986,0,0,0
2011-11-30,0.55,1286890,709528,1996418,0,0,0
2011-12-01,0.63,911659,570797,1482456,0,0,0
2011-12-02,0.58,1004168,579819,1583987,0,0,0
2011-12-05,0.67,889611,600067,1489678,0,0,0
2011-12-06,0.73,754087,553552,1307639,0,0,0
2011-12-07,0.73,854524,623234,1477758,0,0,0
2011-12-08,0.76,849976,649849,1499825,0,0,0
2011-12-09,0.7,798498,555735,1354233,0,0,0
2011-12-12,0.6,988572,597395,1585967,0,0,0
2011-12-13,0.78,875143,679164,1554307,0,0,0
2011-12-14,0.82,926773,763759,1690532,0,0,0
2011-12-15,0.9,756020,680961,1436981,0,0,0
2011-12-16,0.89,1019439,910530,1929969,0,0,0
2011-12-19,0.61,1020381,618236,1638617,0,0,0
2011-12-20,0.53,1070080,562620,1632700,0,0,0
2011-12-21,0.72,835531,597686,1433217,0,0,0
2011-12-22,0.68,810050,551125,1361175,0,0,0
2011-12-23,0.63,599747,377198,976945,0,0,0
2011-12-27,0.71,558135,397591,955726,0,0,0
2011-12-28,0.68,567600,387744,955344,0,0,0
2011-12-29,0.69,561394,389134,950528,0,0,0
2011-12-30,0.54,589406,318032,907438,0,0,0
2012-01-03,0.55,1174201,643884,1818085,0,0,0
2012-01-04,0.74,958616,712281,1670897,0,0,0
2012-01-05,0.61,1077256,652347,1729603,0,0,0
2012-01-06,0.62,1100590,680768,1781358,0,0,0
2012-01-09,0.66,1085118,710848,1795966,0,0,0
2012-01-10,0.57,1363187,781486,2144673,0,0,0
2012-01-11,0.54,1391668,756537,2148205,0,0,0
2012-01-12,0.57,1393805,794150,2187955,0,0,0
2012-01-13,0.6,1268437,758754,2027191,0,0,0
2012-01-17,0.59,1478548,873056,2351604,0,0,0
2012-01-18,0.55,1723542,942411,2665953,0,0,0
2012-01-19,0.48,2280572,1092254,3372826,0,0,0
2012-01-20,0.52,2131429,1106525,3237954,0,0,0
2012-01-23,0.64,1417023,913956,2330979,0,0,0
2012-01-24,0.62,1248117,779382,2027499,0,0,0
2012-01-25,0.57,1605429,908426,2513855,0,0,0
2012-01-26,0.65,1525062,998221,2523283,0,0,0
2012-01-27,0.6,1291738,774494,2066232,0,0,0
2012-01-30,0.67,1072009,715571,1787580,0,0,0
2012-01-31,0.61,1220576,745276,1965852,0,0,0
2012-02-01,0.61,1449718,885436,2335154,0,0,0
2012-02-02,0.62,1286399,801023,2087422,0,0,0
2012-02-03,0.51,1781120,910973,2692093,0,0,0
2012-02-06,0.55,1217203,675324,1892527,0,0,0
2012-02-07,0.58,1432785,832067,2264852,0,0,0
2012-02-08,0.54,1653567,887023,2540590,0,0,0
2012-02-09,0.55,1796556,993180,2789736,0,0,0
2012-02-10,0.75,1376918,1035927,2412845,0,0,0
2012-02-13,0.53,1438352,759199,2197551,0,0,0
2012-02-14,0.6,1508344,902237,2410581,0,0,0
2012-02-15,0.63,1683528,1068545,2752073,0,0,0
2012-02-16,0.62,1781382,1100499,2881881,0,0,0
2012-02-17,0.51,1949713,994518,2944231,0,0,0
2012-02-21,0.61,1639253,1000248,2639501,0,0,0
2012-02-22,0.63,1211002,764194,1975196,0,0,0
2012-02-23,0.67,1289490,868570,2158060,0,0,0
2012-02-24,0.69,1383988,951816,2335804,0,0,0
2012-02-27,0.64,1221894,777824,1999718,0,0,0
2012-02-28,0.57,1330574,755052,2085626,0,0,0
2012-02-29,0.67,1336427,891069,2227496,0,0,0
2012-03-01,0.64,1248014,804519,2052533,0,0,0
2012-03-02,0.6,1166206,699379,1865585,0,0,0
2012-03-05,0.73,1047154,766585,1813739,0,0,0
2012-03-06,0.78,1213578,951054,2164632,0,0,0
2012-03-07,0.62,1029556,633977,1663533,0,0,0
2012-03-08,0.61,1141748,701886,1843634,0,0,0
2012-03-09,0.63,1197362,750474,1947836,0,0,0
2012-03-12,0.7,898419,627780,1526199,0,0,0
2012-03-13,0.59,1557399,921226,2478625,0,0,0
2012-03-14,0.54,1725822,940511,2666333,0,0,0
2012-03-15,0.52,1846330,952089,2798419,0,0,0
2012-03-16,0.46,2182618,998222,3180840,0,0,0
2012-03-19,0.5,1798501,894965,2693466,0,0,0
2012-03-20,0.52,1351148,700140,2051288,0,0,0
2012-03-21,0.55,1333208,739236,2072444,0,0,0
2012-03-22,0.68,1224547,829352,2053899,0,0,0
2012-03-23,0.61,1026148,629781,1655929,0,0,0
2012-03-26,0.72,1173896,845864,2019760,0,0,0
2012-03-27,0.55,1330043,730509,2060552,0,0,0
2012-03-28,0.71,1191911,844178,2036089,0,0,0
2012-03-29,0.67,1181006,788013,1969019,0,0,0
2012-03-30,0.59,1131791,667554,1799345,0,0,0
2012-04-02,0.52,1200952,620688,1821640,0,0,0
2012-04-03,0.57,1260398,721443,1981841,0,0,0
2012-04-04,0.66,1145439,750898,1896337,0,0,0
2012-04-05,0.6,1101165,658742,1759907,0,0,0
2012-04-09,0.69,994687,690064,1684751,0,0,0
2012-04-10,0.67,1628986,1095618,2724604,0,0,0
2012-04-11,0.65,1144137,748956,1893093,0,0,0
2012-04-12,0.51,1509189,772093,2281282,0,0,0
2012-04-13,0.72,1185490,851125,2036615,0,0,0
2012-04-16,0.7,1086308,755500,1841808,0,0,0
2012-04-17,0.57,1249575,714119,1963694,0,0,0
2012-04-18,0.59,1302565,765441,2068006,0,0,0
2012-04-19,0.65,1542896,1005189,2548085,0,0,0
2012-04-20,0.63,1810334,1148223,2958557,0,0,0
2012-04-23,0.59,1291229,759261,2050490,0,0,0
2012-04-24,0.66,1279368,841822,2121190,0,0,0
2012-04-25,0.48,1680153,799745,2479898,0,0,0
2012-04-26,0.62,1361143,842575,2203718,0,0,0
2012-04-27,0.6,1293641,773863,2067504,0,0,0
2012-04-30,0.64,1026951,661471,1688422,0,0,0
2012-05-01,0.53,1329869,705697,2035566,0,0,0
2012-05-02,0.74,1120210,833769,1953979,0,0,0
2012-05-03,0.75,1172988,876759,2049747,0,0,0
2012-05-04,0.71,1299463,922254,2221717,0,0,0
2012-05-07,0.65,1003622,652605,1656227,0,0,0
2012-05-08,0.74,1219890,905821,2125711,0,0,0
2012-05-09,0.67,1182098,790274,1972372,0,0,0
2012-05-10,0.68,1136613,775156,1911769,0,0,0
2012-05-11,0.74,1176811,868406,2045217,0,0,0
2012-05-14,0.84,1019333,855460,1874793,0,0,0
2012-05-15,0.81,1168614,940878,2109492,0,0,0
2012-05-16,0.88,1231446,1082174,2313620,0,0,0
2012-05-17,0.88,1310771,1155895,2466666,0,0,0
2012-05-18,0.99,1375103,1354695,2729798,0,0,0
2012-05-21,0.54,1246192,673789,1919981,0,0,0
2012-05-22,0.63,1226934,778314,2005248,0,0,0
2012-05-23,0.73,1117163,820731,1937894,0,0,0
2012-05-24,0.74,943532,694010,1637542,0,0,0
2012-05-25,0.66,783986,517562,1301548,0,0,0
2012-05-29,0.66,1031028,683253,1714281,0,0,0
2012-05-30,0.77,801273,614386,1415659,0,0,0
2012-05-31,0.79,923184,732937,1656121,0,0,0
2012-06-01,0.79,1183860,936556,2120416,0,0,0
2012-06-04,0.78,1007845,783009,1790854,0,0,0
2012-06-05,0.69,879661,608372,1488033,0,0,0
2012-06-06,0.66,1053399,700483,1753882,0,0,0
2012-06-07,0.64,1102256,702678,1804934,0,0,0
2012-06-08,0.78,763671,592605,1356276,0,0,0
2012-06-11,0.81,827685,670352,1498037,0,0,0
2012-06-12,0.72,881348,633895,1515243,0,0,0
2012-06-13,0.92,839311,770824,1610135,0,0,0
2012-06-14,0.83,942530,778871,1721401,0,0,0
2012-06-15,0.69,1346751,924671,2271422,0,0,0
2012-06-18,0.57,1081996,619807,1701803,0,0,0
2012-06-19,0.59,1126709,663402,1790111,0,0,0
2012-06-20,0.65,948159,617595,1565754,0,0,0
2012-06-21,0.8,919654,739723,1659377,0,0,0
2012-06-22,0.61,947326,579708,1527034,0,0,0
2012-06-25,0.78,786897,611020,1397917,0,0,0
2012-06-26,0.73,805247,590713,1395960,0,0,0
2012-06-27,0.65,881546,576289,1457835,0,0,0
2012-06-28,0.75,899935,676630,1576565,0,0,0
2012-06-29,0.69,1270279,879283,2149562,0,0,0
2012-07-02,0.72,759446,548522,1307968,0,0,0
2012-07-03,0.65,640335,415646,1055981,0,0,0
2012-07-05,0.64,939451,596873,1536324,0,0,0
2012-07-06,0.75,870414,654253,1524667,0,0,0
2012-07-09,0.78,793251,619511,1412762,0,0,0
2012-07-10,0.72,955299,689698,1644997,0,0,0
2012-07-11,0.81,804717,652494,1457211,0,0,0
2012-07-12,0.7,994736,695851,1690587,0,0,0
2012-07-13,0.64,1012954,644297,1657251,0,0,0
2012-07-16,0.67,962910,648633,1611543,0,0,0
2012-07-17,0.67,1163410,777665,1941075,0,0,0
2012-07-18,0.66,1284734,845452,2130186,0,0,0
2012-07-19,0.68,1349600,911648,2261248,0,0,0
2012-07-20,0.75,1412563,1056637,2469200,0,0,0
2012-07-23,0.7,1089472,757243,1846715,0,0,0
2012-07-24,0.66,1183971,778248,1962219,0,0,0
2012-07-25,0.71,1248444,890858,2139302,0,0,0
2012-07-26,0.71,1322521,943021,2265542,0,0,0
2012-07-27,0.64,1513727,962862,2476589,0,0,0
2012-07-30,0.66,1090413,721632,1812045,0,0,0
2012-07-31,0.68,1072316,729447,1801763,0,0,0
2012-08-01,0.72,1103009,790398,1893407,0,0,0
2012-08-02,0.78,1171459,908202,2079661,0,0,0
2012-08-03,0.6,1308579,789668,2098247,0,0,0
2012-08-06,0.63,1054662,662855,1717517,0,0,0
2012-08-07,0.55,1377682,763644,2141326,0,0,0
2012-08-08,0.58,1066535,616166,1682701,0,0,0
2012-08-09,0.62,953953,593172,1547125,0,0,0
2012-08-10,0.7,855382,598031,1453413,0,0,0
2012-08-13,0.56,960123,541205,1501328,0,0,0
2012-08-14,0.66,1033272,685425,1718697,0,0,0
2012-08-15,0.62,1011641,631330,1642971,0,0,0
2012-08-16,0.69,1353451,932643,2286094,0,0,0
2012-08-17,0.54,1611423,871562,2482985,0,0,0
2012-08-20,0.62,1135316,699997,1835313,0,0,0
2012-08-21,0.67,1252580,835419,2087999,0,0,0
2012-08-22,0.65,1061568,694804,1756372,0,0,0
2012-08-23,0.74,1027823,757025,1784848,0,0,0
2012-08-24,0.68,947821,642167,1589988,0,0,0
2012-08-27,0.69,741217,513558,1254775,0,0,0
2012-08-28,0.61,726734,446178,1172912,0,0,0
2012-08-29,0.79,758514,599982,1358496,0,0,0
2012-08-30,0.84,787658,658862,1446520,0,0,0
2012-08-31,0.67,807309,544439,1351748,0,0,0
2012-09-04,0.75,840133,627401,1467534,0,0,0
2012-09-05,0.67,835341,558847,1394188,0,0,0
2012-09-06,0.59,1350646,791247,2141893,0,0,0
2012-09-07,0.54,1463200,791467,2254667,0,0,0
2012-09-10,0.66,1101677,722331,1824008,0,0,0
2012-09-11,0.54,1129634,608112,1737746,0,0,0
2012-09-12,0.57,1184537,674570,1859107,0,0,0
2012-09-13,0.54,1629619,884695,2514314,0,0,0
2012-09-14,0.53,2025732,1078273,3104005,0,0,0
2012-09-17,0.64,949777,611552,1561329,0,0,0
2012-09-18,0.62,1001884,625060,1626944,0,0,0
2012-09-19,0.56,1215430,682607,1898037,0,0,0
2012-09-20,0.75,1156018,871254,2027272,0,0,0
2012-09-21,0.62,1553487,956290,2509777,0,0,0
2012-09-24,0.61,1223172,749700,1972872,0,0,0
2012-09-25,0.73,1078242,789107,1867349,0,0,0
2012-09-26,0.75,943357,703207,1646564,0,0,0
2012-09-27,0.6,1059544,637905,1697449,0,0,0
2012-09-28,0.76,993166,757842,1751008,0,0,0
2012-10-01,0.63,806973,506209,1313182,0,0,0
2012-10-02,0.55,989995,545697,1535692,0,0,0
2012-10-03,0.71,807465,576247,1383712,0,0,0
2012-10-04,0.58,997738,580395,1578133,0,0,0
2012-10-05,0.67,1046389,705326,1751715,0,0,0
2012-10-08,0.55,793422,436801,1230223,0,0,0
2012-10-09,0.73,877529,639567,1517096,0,0,0
2012-10-10,0.71,762456,538309,1300765,0,0,0
2012-10-11,0.65,997304,648899,1646203,0,0,0
2012-10-12,0.74,849072,627047,1476119,0,0,0
2012-10-15,0.73,859239,628977,1488216,0,0,0
2012-10-16,0.61,1112158,681129,1793287,0,0,0
2012-10-17,0.59,1225922,725446,1951368,0,0,0
2012-10-18,0.65,1284758,837975,2122733,0,0,0
2012-10-19,0.8,1251216,998182,2249398,0,0,0
2012-10-22,0.67,909315,605866,1515181,0,0,0
2012-10-23,0.86,897750,768080,1665830,0,0,0
2012-10-24,0.71,872969,615655,1488624,0,0,0
2012-10-25,0.76,843478,639276,1482754,0,0,0
2012-10-26,0.77,945281,725184,1670465,0,0,0
2012-10-31,0.68,857370,580275,1437645,0,0,0
2012-11-01,0.6,975938,586027,1561965,0,0,0
2012-11-02,0.77,994468,763534,1758002,0,0,0
2012-11-05,0.61,758930,463390,1222320,0,0,0
2012-11-06,0.63,817015,517545,1334560,0,0,0
2012-11-07,0.76,966873,733987,1700860,0,0,0
2012-11-08,0.8,936286,745666,1681952,0,0,0
2012-11-09,0.82,911319,744389,1655708,0,0,0
2012-11-12,0.65,775681,503247,1278928,0,0,0
2012-11-13,0.72,893310,640897,1534207,0,0,0
2012-11-14,0.78,919321,719246,1638567,0,0,0
2012-11-15,0.83,909228,757323,1666551,0,0,0
2012-11-16,0.81,1160477,943313,2103790,0,0,0
2012-11-19,0.56,1035614,576154,1611768,0,0,0
2012-11-20,0.67,761575,513648,1275223,0,0,0
2012-11-21,0.61,699929,426322,1126251,0,0,0
2012-11-23,0.59,497512,291635,789147,0,0,0
2012-11-26,0.64,738138,469508,1207646,0,0,0
2012-11-27,0.58,768798,444521,1213319,0,0,0
2012-11-28,0.6,888643,536283,1424926,0,0,0
2012-11-29,0.62,866352,538160,1404512,0,0,0
2012-11-30,0.73,745740,542291,1288031,0,0,0
2012-12-03,0.57,674368,382053,1056421,0,0,0
2012-12-04,0.81,737881,595184,1333065,0,0,0
2012-12-05,0.6,1154784,692004,1846788,0,0,0
2012-12-06,0.67,875270,589825,1465095,0,0,0
2012-12-07,0.64,963736,618237,1581973,0,0,0
2012-12-10,0.62,631082,393857,1024939,0,0,0
2012-12-11,0.59,804092,476050,1280142,0,0,0
2012-12-12,0.61,849253,519336,1368589,0,0,0
2012-12-13,0.61,824832,503724,1328556,0,0,0
2012-12-14,0.7,804531,562311,1366842,0,0,0
2012-12-17,0.6,813761,486331,1300092,0,0,0
2012-12-18,0.51,1140797,578498,1719295,0,0,0
2012-12-19,0.64,892004,568462,1460466,0,0,0
2012-12-20,0.64,879313,566642,1445955,0,0,0
2012-12-21,0.71,1025621,731804,1757425,0,0,0
2012-12-24,0.65,370957,239914,610871,0,0,0
2012-12-26,0.74,590139,436280,1026419,0,0,0
2012-12-27,0.68,704225,480578,1184803,0,0,0
2012-12-28,0.64,672136,429236,1101372,0,0,0
2012-12-31,0.62,777569,485969,1263538,0,0,0
2013-01-02,0.55,1031381,567180,1598561,0,0,0
2013-01-03,0.53,1023718,542126,1565844,0,0,0
2013-01-04,0.64,929392,596575,1525967,0,0,0
2013-01-07,0.68,690162,469158,1159320,0,0,0
2013-01-08,0.78,693048,543080,1236128,0,0,0
2013-01-09,0.61,847872,520752,1368624,0,0,0
2013-01-10,0.66,937748,621614,1559362,0,0,0
2013-01-11,0.63,863049,545871,1408920,0,0,0
2013-01-14,0.52,939954,486423,1426377,0,0,0
2013-01-15,0.67,868787,582208,1450995,0,0,0
2013-01-16,0.75,890353,670859,1561212,0,0,0
2013-01-17,0.61,1007254,611928,1619182,0,0,0
2013-01-18,0.54,1187424,637024,1824448,0,0,0
2013-01-22,0.68,929497,635146,1564643,0,0,0
2013-01-23,0.69,816558,566364,1382922,0,0,0
2013-01-24,0.65,1108726,720079,1828805,0,0,0
2013-01-25,0.64,995873,637911,1633784,0,0,0
2013-01-28,0.76,852221,644295,1496516,0,0,0
2013-01-29,0.68,856151,581147,1437298,0,0,0
2013-01-30,0.67,825206,555135,1380341,0,0,0
2013-01-31,0.73,785568,571152,1356720,0,0,0
2013-02-01,0.57,1020229,586459,1606688,0,0,0
2013-02-04,0.69,765396,531545,1296941,0,0,0
2013-02-05,0.59,943144,558877,1502021,0,0,0
2013-02-06,0.6,888166,529401,1417567,0,0,0
2013-02-07,0.66,806486,534829,1341315,0,0,0
2013-02-08,0.57,924613,524905,1449518,0,0,0
2013-02-11,0.56,824905,465420,1290325,0,0,0
2013-02-12,0.61,925067,561136,1486203,0,0,0
2013-02-13,0.65,1009034,657978,1667012,0,0,0
2013-02-14,0.62,1009032,624707,1633739,0,0,0
2013-02-15,0.59,1233749,732822,1966571,0,0,0
2013-02-19,0.58,944166,545231,1489397,0,0,0
2013-02-20,0.72,910664,659947,1570611,0,0,0
2013-02-21,0.72,1014832,726109,1740941,0,0,0
2013-02-22,0.59,904478,533604,1438082,0,0,0
2013-02-25,0.73,817601,596281,1413882,0,0,0
2013-02-26,0.75,756562,564143,1320705,0,0,0
2013-02-27,0.63,873962,546772,1420734,0,0,0
2013-02-28,0.67,768185,514899,1283084,0,0,0
2013-03-01,0.74,804663,597953,1402616,0,0,0
2013-03-04,0.67,706139,471529,1177668,0,0,0
2013-03-05,0.65,903460,590068,1493528,0,0,0
2013-03-06,0.54,1052419,564012,1616431,0,0,0
2013-03-07,0.59,996967,585654,1582621,0,0,0
2013-03-08,0.62,943952,581943,1525895,0,0,0
2013-03-11,0.65,836681,541525,1378206,0,0,0
2013-03-12,0.61,846886,515018,1361904,0,0,0
2013-03-13,0.62,815238,509199,1324437,0,0,0
2013-03-14,0.64,920340,591614,1511954,0,0,0
2013-03-15,0.56,1279243,712570,1991813,0,0,0
2013-03-18,0.65,788981,510436,1299417,0,0,0
2013-03-19,0.72,867219,627137,1494356,0,0,0
2013-03-20,0.59,789463,462852,1252315,0,0,0
2013-03-21,0.64,796984,506105,1303089,0,0,0
2013-03-22,0.69,818738,567362,1386100,0,0,0
2013-03-25,0.72,796191,569704,1365895,0,0,0
2013-03-26,0.62,634974,396585,1031559,0,0,0
2013-03-27,0.68,688124,464786,1152910,0,0,0
2013-03-28,0.62,769891,481073,1250964,0,0,0
2013-04-01,0.7,614203,427001,1041204,0,0,0
2013-04-02,0.64,748579,480087,1228666,0,0,0
2013-04-03,0.76,829672,627496,1457168,0,0,0
2013-04-04,0.73,658062,482021,1140083,0,0,0
2013-04-05,0.7,738672,520588,1259260,0,0,0
2013-04-08,0.58,625459,362971,988430,0,0,0
2013-04-09,0.6,810861,482828,1293689,0,0,0
2013-04-10,0.58,1040707,599418,1640125,0,0,0
2013-04-11,0.62,967947,598847,1566794,0,0,0
2013-04-12,0.7,802611,564999,1367610,0,0,0
2013-04-15,0.7,1006601,701953,1708554,0,0,0
2013-04-16,0.7,825691,579344,1405035,0,0,0
2013-04-17,0.79,1072115,843020,1915135,0,0,0
2013-04-18,0.75,934624,701609,1636233,0,0,0
2013-04-19,0.85,1004504,852133,1856637,0,0,0
2013-04-22,0.66,872454,575047,1447501,0,0,0
2013-04-23,0.66,969989,636801,1606790,0,0,0
2013-04-24,0.58,1163729,680569,1844298,0,0,0
2013-04-25,0.61,182169,111008,293177,0,0,0
2013-04-26,0.65,749463,486427,1235890,0,0,0
2013-04-29,0.58,813769,475108,1288877,0,0,0
2013-04-30,0.62,852248,529751,1381999,0,0,0
2013-05-01,0.68,843942,572496,1416438,0,0,0
2013-05-02,0.55,885070,484902,1369972,0,0,0
2013-05-03,0.61,1021707,627249,1648956,0,0,0
2013-05-06,0.53,924082,493298,1417380,0,0,0
2013-05-07,0.63,904327,566733,1471060,0,0,0
2013-05-08,0.66,929032,613414,1542446,0,0,0
2013-05-09,0.58,994086,575327,1569413,0,0,0
2013-05-10,0.59,955830,559174,1515004,0,0,0
2013-05-13,0.6,799499,478945,1278444,0,0,0
2013-05-14,0.52,1057497,548126,1605623,0,0,0
2013-05-15,0.52,1108012,579498,1687510,0,0,0
2013-05-16,0.54,1113435,602002,1715437,0,0,0
2013-05-17,0.5,1226557,614159,1840716,0,0,0
2013-05-20,0.52,1035030,540534,1575564,0,0,0
2013-05-21,0.54,906425,490053,1396478,0,0,0
2013-05-22,0.67,1095693,734791,1830484,0,0,0
2013-05-23,0.67,833646,562693,1396339,0,0,0
2013-05-24,0.73,706424,519174,1225598,0,0,0
2013-05-28,0.58,907475,530289,1437764,0,0,0
2013-05-29,0.64,857525,550590,1408115,0,0,0
2013-05-30,0.48,1030791,492508,1523299,0,0,0
2013-05-31,0.66,880284,577641,1457925,0,0,0
2013-06-03,0.63,931143,582323,1513466,0,0,0
2013-06-04,0.67,894939,603049,1497988,0,0,0
2013-06-05,0.73,835660,609976,1445636,0,0,0
2013-06-06,0.63,859324,539721,1399045,0,0,0
2013-06-07,0.67,976741,655799,1632540,0,0,0
2013-06-10,0.59,845798,501983,1347781,0,0,0
2013-06-11,0.81,788150,635892,1424042,0,0,0
2013-06-12,0.75,725716,540785,1266501,0,0,0
2013-06-13,0.63,777567,486640,1264207,0,0,0
2013-06-14,0.73,758927,554549,1313476,0,0,0
2013-06-17,0.65,877602,571871,1449473,0,0,0
2013-06-18,0.54,940922,508724,1449646,0,0,0
2013-06-19,0.66,854718,559941,1414659,0,0,0
2013-06-20,0.79,1220384,964067,2184451,0,0,0
2013-06-21,0.82,1517087,1247238,2764325,0,0,0
2013-06-24,0.65,1175933,769071,1945004,0,0,0
2013-06-25,0.59,856425,503173,1359598,0,0,0
2013-06-26,0.67,882003,595294,1477297,0,0,0
2013-06-27,0.71,896389,640428,1536817,0,0,0
2013-06-28,0.66,833558,546963,1380521,0,0,0
2013-07-01,0.6,800235,479294,1279529,0,0,0
2013-07-02,0.65,816181,531877,1348058,0,0,0
2013-07-03,0.76,464302,353401,817703,0,0,0
2013-07-05,0.6,701172,424061,1125233,0,0,0
2013-07-08,0.69,800223,554842,1355065,0,0,0
2013-07-09,0.54,1004361,546116,1550477,0,0,0
2013-07-10,0.57,909653,520132,1429785,0,0,0
2013-07-11,0.57,1088343,625051,1713394,0,0,0
2013-07-12,0.67,992492,661075,1653567,0,0,0
2013-07-15,0.53,1041127,549537,1590664,0,0,0
2013-07-16,0.64,1056233,672482,1728715,0,0,0
2013-07-17,0.62,1180834,729781,1910615,0,0,0
2013-07-18,0.5,1431352,709351,2140703,0,0,0
2013-07-19,0.54,1550856,843540,2394396,0,0,0
2013-07-22,0.67,1022900,682552,1705452,0,0,0
2013-07-23,0.66,1058992,693978,1752970,0,0,0
2013-07-24,0.65,1101178,717390,1818568,0,0,0
2013-07-25,0.59,1155473,683664,1839137,0,0,0
2013-07-26,0.64,966413,622756,1589169,0,0,0
2013-07-29,0.6,883035,527507,1410542,0,0,0
2013-07-30,0.56,1140176,637829,1778005,0,0,0
2013-07-31,0.6,1088383,649966,1738349,0,0,0
2013-08-01,0.55,1178959,650748,1829707,0,0,0
2013-08-02,0.58,1051078,607739,1658817,0,0,0
2013-08-05,0.59,931789,548187,1479976,0,0,0
2013-08-06,0.63,987293,622038,1609331,0,0,0
2013-08-07,0.63,987502,625431,1612933,0,0,0
2013-08-08,0.58,1114452,641593,1756045,0,0,0
2013-08-09,0.58,1116893,650352,1767245,0,0,0
2013-08-12,0.55,1034464,571858,1606322,0,0,0
2013-08-13,0.49,1360792,669341,2030133,0,0,0
2013-08-14,0.53,1326331,708597,2034928,0,0,0
2013-08-15,0.66,1293346,848218,2141564,0,0,0
2013-08-16,0.6,1338157,798234,2136391,0,0,0
2013-08-19,0.54,1102624,595360,1697984,0,0,0
2013-08-20,0.61,992955,603745,1596700,0,0,0
2013-08-21,0.64,938774,605156,1543930,0,0,0
2013-08-22,0.55,791998,434075,1226073,0,0,0
2013-08-23,0.6,1069709,641067,1710776,0,0,0
2013-08-26,0.61,902411,547455,1449866,0,0,0
2013-08-27,0.68,919663,625133,1544796,0,0,0
2013-08-28,0.55,819541,446751,1266292,0,0,0
2013-08-29,0.6,767414,461727,1229141,0,0,0
2013-08-30,0.67,696974,470454,1167428,0,0,0
2013-09-03,0.54,947368,513901,1461269,0,0,0
2013-09-04,0.54,988507,538592,1527099,0,0,0
2013-09-05,0.52,923418,481843,1405261,0,0,0
2013-09-06,0.5,1125139,563541,1688680,0,0,0
2013-09-09,0.45,1057353,479336,1536689,0,0,0
2013-09-10,0.48,1178951,566417,1745368,0,0,0
2013-09-11,0.61,1066539,651879,1718418,0,0,0
2013-09-12,0.63,985262,624424,1609686,0,0,0
2013-09-13,0.6,907155,541493,1448648,0,0,0
2013-09-16,0.57,990144,567465,1557609,0,0,0
2013-09-17,0.57,1001072,574060,1575132,0,0,0
2013-09-18,0.53,1353970,720318,2074288,0,0,0
2013-09-19,0.57,1334625,764473,2099098,0,0,0
2013-09-20,0.6,1410621,841277,2251898,0,0,0
2013-09-23,0.7,1103600,769159,1872759,0,0,0
2013-09-24,0.56,1213513,684217,1897730,0,0,0
2013-09-25,0.62,998811,615794,1614605,0,0,0
2013-09-26,0.49,1372332,668252,2040584,0,0,0
2013-09-27,0.7,1098107,768766,1866873,0,0,0
2013-09-30,0.76,892766,680664,1573430,0,0,0
2013-10-01,0.53,1058205,557455,1615660,0,0,0
2013-10-02,0.61,989049,598837,1587886,0,0,0
2013-10-03,0.69,1025559,712575,1738134,0,0,0
2013-10-04,0.59,1027808,605763,1633571,0,0,0
2013-10-07,0.6,900560,543556,1444116,0,0,0
2013-10-08,0.72,1096605,789272,1885877,0,0,0
2013-10-09,0.69,1141280,784876,1926156,0,0,0
2013-10-10,0.63,1071340,669637,1740977,0,0,0
2013-10-11,0.6,1134755,677311,1812066,0,0,0
2013-10-14,0.59,926472,551031,1477503,0,0,0
2013-10-15,0.66,1076966,711160,1788126,0,0,0
2013-10-16,0.54,1220545,659086,1879631,0,0,0
2013-10-17,0.54,1420025,768132,2188157,0,0,0
2013-10-18,0.46,2062165,944934,3007099,0,0,0
2013-10-21,0.53,1431721,765823,2197544,0,0,0
2013-10-22,0.54,1434251,780403,2214654,0,0,0
2013-10-23,0.58,1323496,772000,2095496,0,0,0
2013-10-24,0.6,1320529,786479,2107008,0,0,0
2013-10-25,0.64,1223113,784715,2007828,0,0,0
2013-10-28,0.53,1255763,659765,1915528,0,0,0
2013-10-29,0.52,1429088,740134,2169222,0,0,0
2013-10-30,0.6,1260066,753919,2013985,0,0,0
2013-10-31,0.57,1232305,699013,1931318,0,0,0
2013-11-01,0.61,1166171,708134,1874305,0,0,0
2013-11-04,0.54,1198172,649486,1847658,0,0,0
2013-11-05,0.57,1162203,660127,1822330,0,0,0
2013-11-06,0.58,1202490,702505,1904995,0,0,0
2013-11-07,0.57,1429654,819267,2248921,0,0,0
2013-11-08,0.51,1412367,716262,2128629,0,0,0
2013-11-11,0.52,1065479,555297,1620776,0,0,0
2013-11-12,0.55,1130728,625004,1755732,0,0,0
2013-11-13,0.56,1172404,651593,1823997,0,0,0
2013-11-14,0.59,1328265,781600,2109865,0,0,0
2013-11-15,0.55,1527023,836216,2363239,0,0,0
2013-11-18,0.58,1403036,816473,2219509,0,0,0
2013-11-19,0.69,1056727,728222,1784949,0,0,0
2013-11-20,0.63,993467,626207,1619674,0,0,0
2013-11-21,0.48,1170485,558737,1729222,0,0,0
2013-11-22,0.6,1199895,718540,1918435,0,0,0
2013-11-25,0.54,1129604,610053,1739657,0,0,0
2013-11-26,0.54,1148435,620271,1768706,0,0,0
2013-11-27,0.6,962310,572765,1535075,0,0,0
2013-11-29,0.48,675800,321804,997604,0,0,0
2013-12-02,0.51,1022657,526172,1548829,0,0,0
2013-12-03,0.61,998346,605372,1603718,0,0,0
2013-12-04,0.56,1021052,576083,1597135,0,0,0
2013-12-05,0.52,1091333,564836,1656169,0,0,0
2013-12-06,0.53,1150004,610125,1760129,0,0,0
2013-12-09,0.62,987552,610511,1598063,0,0,0
2013-12-10,0.58,933277,537039,1470316,0,0,0
2013-12-11,0.62,988384,609726,1598110,0,0,0
2013-12-12,0.53,1070098,563694,1633792,0,0,0
2013-12-13,0.67,964168,643938,1608106,0,0,0
2013-12-16,0.5,967608,481954,1449562,0,0,0
2013-12-17,0.53,1052970,561173,1614143,0,0,0
2013-12-18,0.62,1307296,814502,2121798,0,0,0
2013-12-19,0.52,1173892,611810,1785702,0,0,0
2013-12-20,0.5,1674286,831986,2506272,0,0,0
2013-12-23,0.49,1329187,654076,1983263,0,0,0
2013-12-24,0.46,617199,286322,903521,0,0,0
2013-12-26,0.59,841970,496660,1338630,0,0,0
2013-12-27,0.54,1060337,567824,1628161,0,0,0
2013-12-30,0.49,1029930,506622,1536552,0,0,0
2013-12-31,0.46,993447,453040,1446487,0,0,0
2014-01-02,0.56,1095587,616347,1711934,0,0,0
2014-01-03,0.54,1148373,623494,1771867,0,0,0
2014-01-06,0.52,1287636,673624,1961260,0,0,0
2014-01-07,0.47,1414866,667557,2082423,0,0,0
2014-01-08,0.5,1414755,710741,2125496,0,0,0
2014-01-09,0.55,1492315,814895,2307210,0,0,0
2014-01-10,0.53,1608895,849179,2458074,0,0,0
2014-01-13,0.61,1440922,878355,2319277,0,0,0
2014-01-14,0.52,1394833,726999,2121832,0,0,0
2014-01-15,0.48,1845563,891302,2736865,0,0,0
2014-01-16,0.57,1576034,890926,2466960,0,0,0
2014-01-17,0.53,1979449,1049060,3028509,0,0,0
2014-01-21,0.57,1492797,857055,2349852,0,0,0
2014-01-22,0.52,1407929,734749,2142678,0,0,0
2014-01-23,0.65,1346004,879643,2225647,0,0,0
2014-01-24,0.69,1660673,1146225,2806898,0,0,0
2014-01-27,0.53,1496685,793579,2290264,0,0,0
2014-01-28,0.53,1225915,648952,1874867,0,0,0
2014-01-29,0.62,1202254,746970,1949224,0,0,0
2014-01-30,0.54,1345559,726483,2072042,0,0,0
2014-01-31,0.66,1343844,886751,2230595,0,0,0
2014-02-03,0.61,1366803,840283,2207086,0,0,0
2014-02-04,0.6,1159295,693919,1853214,0,0,0
2014-02-05,0.62,1254114,772771,2026885,0,0,0
2014-02-06,0.61,1258650,765132,2023782,0,0,0
2014-02-07,0.68,1385288,939405,2324693,0,0,0
2014-02-10,0.71,1016821,717369,1734190,0,0,0
2014-02-11,0.55,1282550,707899,1990449,0,0,0
2014-02-12,0.64,1091205,698278,1789483,0,0,0
2014-02-13,0.57,1353117,768603,2121720,0,0,0
2014-02-14,0.57,1254467,720650,1975117,0,0,0
2014-02-18,0.61,1231461,749959,1981420,0,0,0
2014-02-19,0.55,1311492,724952,2036444,0,0,0
2014-02-20,0.58,1300181,751977,2052158,0,0,0
2014-02-21,0.55,1619551,894944,2514495,0,0,0
2014-02-24,0.55,1446605,794231,2240836,0,0,0
2014-02-25,0.57,1291604,730752,2022356,0,0,0
2014-02-26,0.57,1313950,755043,2068993,0,0,0
2014-02-27,0.58,1215816,710189,1926005,0,0,0
2014-02-28,0.63,1422140,895915,2318055,0,0,0
2014-03-03,0.62,1021232,634616,1655848,0,0,0
2014-03-04,0.48,1293919,617979,1911898,0,0,0
2014-03-05,0.46,1350090,614508,1964598,0,0,0
2014-03-06,0.53,1337040,703345,2040385,0,0,0
2014-03-07,0.55,1283407,709704,1993111,0,0,0
2014-03-10,0.67,973428,650435,1623863,0,0,0
2014-03-11,0.58,1190112,691972,1882084,0,0,0
2014-03-12,0.71,949706,672270,1621976,0,0,0
2014-03-13,0.69,1224166,846943,2071109,0,0,0
2014-03-14,0.69,1255743,864258,2120001,0,0,0
2014-03-17,0.57,987063,560258,1547321,0,0,0
2014-03-18,0.55,1044200,569299,1613499,0,0,0
2014-03-19,0.53,1128832,596821,1725653,0,0,0
2014-03-20,0.55,1313327,718867,2032194,0,0,0
2014-03-21,0.62,1623688,1004979,2628667,0,0,0
2014-03-24,0.66,1230940,807877,2038817,0,0,0
2014-03-25,0.53,1201404,641657,1843061,0,0,0
2014-03-26,0.64,1190334,765067,1955401,0,0,0
2014-03-27,0.57,1245466,712028,1957494,0,0,0
2014-03-28,0.64,1132631,728463,1861094,0,0,0
2014-03-31,0.57,957440,543919,1501359,0,0,0
2014-04-01,0.47,1140176,535526,1675702,0,0,0
2014-04-02,0.51,1034225,532460,1566685,0,0,0
2014-04-03,0.59,1036264,616291,1652555,0,0,0
2014-04-04,0.65,1353316,881123,2234439,0,0,0
2014-04-07,0.62,1191687,735204,1926891,0,0,0
2014-04-08,0.56,992829,558607,1551436,0,0,0
2014-04-09,0.45,1215530,551511,1767041,0,0,0
2014-04-10,0.7,1030621,720460,1751081,0,0,0
2014-04-11,0.75,1085976,814735,1900711,0,0,0
2014-04-14,0.61,930636,569535,1500171,0,0,0
2014-04-15,0.59,1193003,703254,1896257,0,0,0
2014-04-16,0.53,1219255,651101,1870356,0,0,0
2014-04-17,0.57,1461005,838080,2299085,0,0,0
2014-04-21,0.47,1068453,502807,1571260,0,0,0
2014-04-22,0.48,1089786,520429,1610215,0,0,0
2014-04-23,0.69,1052651,728528,1781179,0,0,0
2014-04-24,0.61,1258327,767066,2025393,0,0,0
2014-04-25,0.71,1205943,861370,2067313,0,0,0
2014-04-28,0.69,1258431,865253,2123684,0,0,0
2014-04-29,0.61,1090565,666455,1757020,0,0,0
2014-04-30,0.54,1125769,608590,1734359,0,0,0
2014-05-01,0.56,1192726,668824,1861550,0,0,0
2014-05-02,0.65,955063,621648,1576711,0,0,0
2014-05-05,0.65,781443,508622,1290065,0,0,0
2014-05-06,0.68,1049527,713728,1763255,0,0,0
2014-05-07,0.67,1183947,798214,1982161,0,0,0
2014-05-08,0.66,1095234,718012,1813246,0,0,0
2014-05-09,0.72,981880,710647,1692527,0,0,0
2014-05-12,0.53,1045035,552397,1597432,0,0,0
2014-05-13,0.61,981878,598112,1579990,0,0,0
2014-05-14,0.72,839671,600405,1440076,0,0,0
2014-05-15,0.69,1075564,741764,1817328,0,0,0
2014-05-16,0.68,1149404,783528,1932932,0,0,0
2014-05-19,0.54,1031567,556188,1587755,0,0,0
2014-05-20,0.66,893701,589710,1483411,0,0,0
2014-05-21,0.68,851930,575500,1427430,0,0,0
2014-05-22,0.71,861051,610257,1471308,0,0,0
2014-05-23,0.58,1016591,591881,1608472,0,0,0
2014-05-27,0.53,1090183,580342,1670525,0,0,0
2014-05-28,0.56,863949,486654,1350603,0,0,0
2014-05-29,0.52,1036011,543871,1579882,0,0,0
2014-05-30,0.56,1145218,638659,1783877,0,0,0
2014-06-02,0.62,774029,482891,1256920,0,0,0
2014-06-03,0.58,811243,468995,1280238,0,0,0
2014-06-04,0.43,1145475,493350,1638825,0,0,0
2014-06-05,0.5,1073466,535021,1608487,0,0,0
2014-06-06,0.47,1281037,608426,1889463,0,0,0
2014-06-09,0.48,1128969,536838,1665807,0,0,0
2014-06-10,0.52,1218867,628130,1846997,0,0,0
2014-06-11,0.5,1047813,525927,1573740,0,0,0
2014-06-12,0.51,1277212,650399,1927611,0,0,0
2014-06-13,0.56,1154670,645157,1799827,0,0,0
2014-06-16,0.48,993144,473976,1467120,0,0,0
2014-06-17,0.49,1033096,503924,1537020,0,0,0
2014-06-18,0.38,1349175,516593,1865768,0,0,0
2014-06-19,0.47,1206358,561002,1767360,0,0,0
2014-06-20,0.52,1600399,825912,2426311,0,0,0
2014-06-23,0.54,1231397,666232,1897629,0,0,0
2014-06-24,0.52,1203627,625342,1828969,0,0,0
2014-06-25,0.49,1064427,517206,1581633,0,0,0
2014-06-26,0.58,980298,565779,1546077,0,0,0
2014-06-27,0.52,1032959,538787,1571746,0,0,0
2014-06-30,0.5,1020910,513842,1534752,0,0,0
2014-07-01,0.51,1212579,623259,1835838,0,0,0
2014-07-02,0.57,1020080,585984,1606064,0,0,0
2014-07-03,0.49,814918,401851,1216769,0,0,0
2014-07-07,0.61,1074838,653092,1727930,0,0,0
2014-07-08,0.63,1225028,768609,1993637,0,0,0
2014-07-09,0.54,996828,539015,1535843,0,0,0
2014-07-10,0.67,981919,658585,1640504,0,0,0
2014-07-11,0.54,1176086,635493,1811579,0,0,0
2014-07-14,0.58,1034655,596017,1630672,0,0,0
2014-07-15,0.58,1070916,621050,1691966,0,0,0
2014-07-16,0.5,1544338,770552,2314890,0,0,0
2014-07-17,0.67,1336899,889963,2226862,0,0,0
2014-07-18,0.56,1554179,865032,2419211,0,0,0
2014-07-21,0.62,989087,612984,1602071,0,0,0
2014-07-22,0.59,1204019,707694,1911713,0,0,0
2014-07-23,0.59,1451893,853875,2305768,0,0,0
2014-07-24,0.58,1265176,730137,1995313,0,0,0
2014-07-25,0.62,1165984,717631,1883615,0,0,0
2014-07-28,0.59,1014794,595747,1610541,0,0,0
2014-07-29,0.6,1069898,639071,1708969,0,0,0
2014-07-30,0.57,1175991,673820,1849811,0,0,0
2014-07-31,0.64,1443155,916681,2359836,0,0,0
2014-08-01,1.04,1116272,1156395,2272667,0,0,0
2014-08-04,0.63,817377,513555,1330932,0,0,0
2014-08-05,0.74,792536,586926,1379462,0,0,0
2014-08-06,0.8,856101,686877,1542978,0,0,0
2014-08-07,0.65,1004791,648128,1652919,0,0,0
2014-08-08,0.65,908680,594034,1502714,0,0,0
2014-08-11,0.57,884384,502522,1386906,0,0,0
2014-08-12,0.67,809947,539081,1349028,0,0,0
2014-08-13,0.65,1019648,665552,1685200,0,0,0
2014-08-14,0.6,1012068,607912,1619980,0,0,0
2014-08-15,0.63,1350137,855030,2205167,0,0,0
2014-08-18,0.5,1104230,553213,1657443,0,0,0
2014-08-19,0.58,969422,561842,1531264,0,0,0
2014-08-20,0.56,825343,462892,1288235,0,0,0
2014-08-21,0.51,975017,497556,1472573,0,0,0
2014-08-22,0.56,999928,561866,1561794,0,0,0
2014-08-25,0.64,729525,463559,1193084,0,0,0
2014-08-26,0.53,886857,472129,1358986,0,0,0
2014-08-27,0.62,858107,529634,1387741,0,0,0
2014-08-28,0.62,774286,476577,1250863,0,0,0
2014-08-29,0.56,897281,506634,1403915,0,0,0
2014-09-02,0.63,1112719,704985,1817704,0,0,0
2014-09-03,0.65,1242695,802673,2045368,0,0,0
2014-09-04,0.65,1110373,723850,1834223,0,0,0
2014-09-05,0.62,1167493,724797,1892290,0,0,0
2014-09-08,0.61,1043570,636780,1680350,0,0,0
2014-09-09,0.59,1298158,759590,2057748,0,0,0
2014-09-10,0.58,1187148,691423,1878571,0,0,0
2014-09-11,0.64,986233,627508,1613741,0,0,0
2014-09-12,0.58,1352531,785721,2138252,0,0,0
2014-09-15,0.61,1191979,731113,1923092,0,0,0
2014-09-16,0.64,1104894,706969,1811863,0,0,0
2014-09-17,0.58,1068025,621497,1689522,0,0,0
2014-09-18,0.62,1228861,762798,1991659,0,0,0
2014-09-19,0.55,1712051,939686,2651737,0,0,0
2014-09-22,0.69,1159234,794183,1953417,0,0,0
2014-09-23,0.66,1038232,681676,1719908,0,0,0
2014-09-24,0.63,988521,625336,1613857,0,0,0
2014-09-25,0.77,1098824,848474,1947298,0,0,0
2014-09-26,0.71,992295,703023,1695318,0,0,0
2014-09-29,0.7,901681,635172,1536853,0,0,0
2014-09-30,0.65,1058595,692797,1751392,0,0,0
2014-10-01,0.78,1040041,815545,1855586,0,0,0
2014-10-02,0.62,1293607,796103,2089710,0,0,0
2014-10-03,0.54,1295434,693298,1988732,0,0,0
2014-10-06,0.63,996033,627190,1623223,0,0,0
2014-10-07,0.63,1039321,659251,1698572,0,0,0
2014-10-08,0.66,1344522,882366,2226888,0,0,0
2014-10-09,0.75,1248713,940010,2188723,0,0,0
2014-10-10,0.87,1391179,1207411,2598590,0,0,0
2014-10-13,0.91,1064687,969292,2033979,0,0,0
2014-10-14,0.78,1218284,954952,2173236,0,0,0
2014-10-15,0.76,1547938,1173661,2721599,0,0,0
2014-10-16,0.64,1357788,865669,2223457,0,0,0
2014-10-17,0.71,1532980,1085677,2618657,0,0,0
2014-10-20,0.59,1150775,674191,1824966,0,0,0
2014-10-21,0.6,1360425,821370,2181795,0,0,0
2014-10-22,0.74,1093621,811603,1905224,0,0,0
2014-10-23,0.61,1219121,744641,1963762,0,0,0
2014-10-24,0.63,1217007,765885,1982892,0,0,0
2014-10-27,0.66,916671,609083,1525754,0,0,0
2014-10-28,0.67,1222794,818915,2041709,0,0,0
2014-10-29,0.72,1089307,789150,1878457,0,0,0
2014-10-30,0.58,1182953,687197,1870150,0,0,0
2014-10-31,0.5,1611418,810601,2422019,0,0,0
2014-11-03,0.61,1157725,702597,1860322,0,0,0
2014-11-04,0.67,1019783,679470,1699253,0,0,0
2014-11-05,0.63,1015430,638753,1654183,0,0,0
2014-11-06,0.69,1028457,705352,1733809,0,0,0
2014-11-07,0.57,1166907,661445,1828352,0,0,0
2014-11-10,0.67,940321,629553,1569874,0,0,0
2014-11-11,0.64,860137,553978,1414115,0,0,0
2014-11-12,0.61,1207781,733384,1941165,0,0,0
2014-11-13,0.57,1328653,752423,2081076,0,0,0
2014-11-14,0.53,1310676,694455,2005131,0,0,0
2014-11-17,0.56,1140115,634422,1774537,0,0,0
2014-11-18,0.47,1272792,599152,1871944,0,0,0
2014-11-19,0.6,1059306,632848,1692154,0,0,0
2014-11-20,0.55,1156174,631602,1787776,0,0,0
2014-11-21,0.49,1582985,771664,2354649,0,0,0
2014-11-24,0.54,1126568,613312,1739880,0,0,0
2014-11-25,0.62,1050732,655394,1706126,0,0,0
2014-11-26,0.63,913352,577949,1491301,0,0,0
2014-11-28,0.65,810374,526359,1336733,0,0,0
2014-12-01,0.62,1247547,776232,2023779,0,0,0
2014-12-02,0.65,953300,615297,1568597,0,0,0
2014-12-03,0.65,935706,604914,1540620,0,0,0
2014-12-04,0.66,876429,579656,1456085,0,0,0
2014-12-05,0.5,1329311,663258,1992569,0,0,0
2014-12-08,0.62,1240062,764250,2004312,0,0,0
2014-12-09,0.78,996670,774691,1771361,0,0,0
2014-12-10,0.74,1002145,743328,1745473,0,0,0
2014-12-11,0.72,928958,664359,1593317,0,0,0
2014-12-12,0.79,1086847,855211,1942058,0,0,0
2014-12-15,0.75,1234503,920988,2155491,0,0,0
2014-12-16,0.74,1101241,811260,1912501,0,0,0
2014-12-17,0.71,1091917,772942,1864859,0,0,0
2014-12-18,0.58,1196527,691629,1888156,0,0,0
2014-12-19,0.59,1425468,835661,2261129,0,0,0
2014-12-22,0.49,1173290,575930,1749220,0,0,0
2014-12-23,0.52,1119764,582043,1701807,0,0,0
2014-12-24,0.6,465330,279144,744474,0,0,0
2014-12-26,0.55,764179,421432,1185611,0,0,0
2014-12-29,0.64,715893,460147,1176040,0,0,0
2014-12-30,0.66,659330,437283,1096613,0,0,0
2014-12-31,0.56,906399,507239,1413638,0,0,0
2015-01-02,0.8,813248,649175,1462423,0,0,0
2015-01-05,0.79,885287,695746,1581033,0,0,0
2015-01-06,0.59,1298604,770872,2069476,0,0,0
2015-01-07,0.73,949054,690637,1639691,0,0,0
2015-01-08,0.54,1215395,655615,1871010,0,0,0
2015-01-09,0.64,1023253,654819,1678072,0,0,0
2015-01-12,0.68,982561,672618,1655179,0,0,0
2015-01-13,0.66,1346444,883389,2229833,0,0,0
2015-01-14,0.75,1136349,856272,1992621,0,0,0
2015-01-15,0.72,1236347,893380,2129727,0,0,0
2015-01-16,0.68,1610252,1095682,2705934,0,0,0
2015-01-20,0.61,942491,578526,1521017,0,0,0
2015-01-21,0.6,865632,519089,1384721,0,0,0
2015-01-22,0.58,1121261,649877,1771138,0,0,0
2015-01-23,0.7,995244,695310,1690554,0,0,0
2015-01-26,0.66,865102,568997,1434099,0,0,0
2015-01-27,0.76,945523,716428,1661951,0,0,0
2015-01-28,0.67,1235207,830467,2065674,0,0,0
2015-01-29,0.79,1143484,902777,2046261,0,0,0
2015-01-30,0.68,1121537,757868,1879405,0,0,0
2015-02-02,0.76,776991,590705,1367696,0,0,0
2015-02-03,0.54,1113184,599278,1712462,0,0,0
2015-02-04,0.59,971527,572415,1543942,0,0,0
2015-02-05,0.66,1023640,679280,1702920,0,0,0
2015-02-06,0.69,1210669,834697,2045366,0,0,0
2015-02-09,0.75,812519,611411,1423930,0,0,0
2015-02-10,0.66,897029,590045,1487074,0,0,0
2015-02-11,0.63,1050724,658556,1709280,0,0,0
2015-02-12,0.55,1303587,720993,2024580,0,0,0
2015-02-13,0.56,1318555,739576,2058131,0,0,0
2015-02-17,0.58,1008659,586234,1594893,0,0,0
2015-02-18,0.58,971501,562922,1534423,0,0,0
2015-02-19,0.55,1143088,625633,1768721,0,0,0
2015-02-20,0.53,1365182,727169,2092351,0,0,0
2015-02-23,0.62,1010308,623947,1634255,0,0,0
2015-02-24,0.57,1053088,599174,1652262,0,0,0
2015-02-25,0.64,1074931,684344,1759275,0,0,0
2015-02-26,0.65,1139947,744545,1884492,0,0,0
2015-02-27,0.64,1058409,682380,1740789,0,0,0
2015-03-02,0.57,777346,444643,1221989,0,0,0
2015-03-03,0.66,830818,545030,1375848,0,0,0
2015-03-04,0.61,798636,489223,1287859,0,0,0
2015-03-05,0.64,916597,588088,1504685,0,0,0
2015-03-06,0.67,1116602,743627,1860229,0,0,0
2015-03-09,0.65,884937,575347,1460284,0,0,0
2015-03-10,0.67,885807,596476,1482283,0,0,0
2015-03-11,0.67,872647,580798,1453445,0,0,0
2015-03-12,0.65,947977,618462,1566439,0,0,0
2015-03-13,0.8,884064,706676,1590740,0,0,0
2015-03-16,0.69,798554,548211,1346765,0,0,0
2015-03-17,0.74,779655,579485,1359140,0,0,0
2015-03-18,0.65,979088,639101,1618189,0,0,0
2015-03-19,0.59,987129,583905,1571034,0,0,0
2015-03-20,0.57,1319315,756553,2075868,0,0,0
2015-03-23,0.56,907438,503796,1411234,0,0,0
2015-03-24,0.7,751475,523710,1275185,0,0,0
2015-03-25,0.69,987157,684767,1671924,0,0,0
2015-03-26,0.58,994232,581586,1575818,0,0,0
2015-03-27,0.79,789359,625401,1414760,0,0,0
2015-03-30,0.53,794197,419926,1214123,0,0,0
2015-03-31,0.65,663299,433090,1096389,0,0,0
2015-04-01,0.76,761303,580431,1341734,0,0,0
2015-04-02,0.81,756875,611739,1368614,0,0,0
2015-04-06,0.5,773281,383367,1156648,0,0,0
2015-04-07,0.59,689156,409014,1098170,0,0,0
2015-04-08,0.6,789917,474811,1264728,0,0,0
2015-04-09,0.6,758171,452847,1211018,0,0,0
2015-04-10,0.54,984782,531953,1516735,0,0,0
2015-04-13,0.59,865840,512653,1378493,0,0,0
2015-04-14,0.66,827264,546388,1373652,0,0,0
2015-04-15,0.59,1066847,631818,1698665,0,0,0
2015-04-16,0.67,1062271,708283,1770554,0,0,0
2015-04-17,0.74,1190104,877867,2067971,0,0,0
2015-04-20,0.56,991351,553385,1544736,0,0,0
2015-04-21,0.64,791276,505138,1296414,0,0,0
2015-04-22,0.57,997741,572000,1569741,0,0,0
2015-04-23,0.66,1052971,691952,1744923,0,0,0
2015-04-24,0.6,1155044,696136,1851180,0,0,0
2015-04-27,0.65,1047466,685131,1732597,0,0,0
2015-04-28,0.64,1121640,714654,1836294,0,0,0
2015-04-29,0.69,1067503,733279,1800782,0,0,0
2015-04-30,0.72,1037691,751906,1789597,0,0,0
2015-05-01,0.61,1029649,629136,1658785,0,0,0
2015-05-04,0.55,789566,431329,1220895,0,0,0
2015-05-05,0.74,884002,657404,1541406,0,0,0
2015-05-06,0.73,881868,646786,1528654,0,0,0
2015-05-07,0.69,751025,519715,1270740,0,0,0
2015-05-08,0.55,1024172,559959,1584131,0,0,0
2015-05-11,0.61,724288,439172,1163460,0,0,0
2015-05-12,0.64,695793,445738,1141531,0,0,0
2015-05-13,0.56,796087,449568,1245655,0,0,0
2015-05-14,0.6,907237,542668,1449905,0,0,0
2015-05-15,0.56,1076432,600873,1677305,0,0,0
2015-05-18,0.66,922192,608786,1530978,0,0,0
2015-05-19,0.59,803780,475949,1279729,0,0,0
2015-05-20,0.58,828220,481436,1309656,0,0,0
2015-05-21,0.71,788524,559851,1348375,0,0,0
2015-05-22,0.64,758622,488171,1246793,0,0,0
2015-05-26,0.74,731884,538147,1270031,0,0,0
2015-05-27,0.58,739801,430444,1170245,0,0,0
2015-05-28,0.71,685900,484098,1169998,0,0,0
2015-05-29,0.57,837624,474986,1312610,0,0,0
2015-06-01,0.66,795045,524175,1319220,0,0,0
2015-06-02,0.54,718968,389004,1107972,0,0,0
2015-06-03,0.51,769105,393757,1162862,0,0,0
2015-06-04,0.61,823072,503836,1326908,0,0,0
2015-06-05,0.61,801071,489179,1290250,0,0,0
2015-06-08,0.61,795341,485865,1281206,0,0,0
2015-06-09,0.63,752022,470424,1222446,0,0,0
2015-06-10,0.46,956113,437968,1394081,0,0,0
2015-06-11,0.59,710363,416199,1126562,0,0,0
2015-06-12,0.67,705718,475420,1181138,0,0,0
2015-06-15,0.66,672729,446621,1119350,0,0,0
2015-06-16,0.64,696396,447488,1143884,0,0,0
2015-06-17,0.55,816228,449783,1266011,0,0,0
2015-06-18,0.64,876345,557008,1433353,0,0,0
2015-06-19,0.63,998061,625415,1623476,0,0,0
2015-06-22,0.56,812292,452184,1264476,0,0,0
2015-06-23,0.61,779859,478441,1258300,0,0,0
2015-06-24,0.52,817929,422248,1240177,0,0,0
2015-06-25,0.65,719633,467709,1187342,0,0,0
2015-06-26,0.74,782894,580590,1363484,0,0,0
2015-06-29,0.94,710695,665510,1376205,0,0,0
2015-06-30,0.84,639602,535007,1174609,0,0,0
2015-07-01,0.62,650570,405178,1055748,0,0,0
2015-07-02,0.7,591448,412949,1004397,0,0,0
2015-07-06,0.65,689268,446441,1135709,0,0,0
2015-07-07,0.78,877764,683815,1561579,0,0,0
2015-07-08,0.87,647140,560924,1208064,0,0,0
2015-07-09,0.69,806406,556342,1362748,0,0,0
2015-07-10,0.67,768790,516646,1285436,0,0,0
2015-07-13,0.55,816857,452479,1269336,0,0,0
2015-07-14,0.63,786771,497364,1284135,0,0,0
2015-07-15,0.68,787137,534632,1321769,0,0,0
2015-07-16,0.71,969909,688171,1658080,0,0,0
2015-07-17,0.55,1230884,679313,1910197,0,0,0
2015-07-20,0.56,1031393,579921,1611314,0,0,0
2015-07-21,0.69,802074,552672,1354746,0,0,0
2015-07-22,0.61,1038895,638721,1677616,0,0,0
2015-07-23,0.78,869933,680213,1550146,0,0,0
2015-07-24,0.86,877490,754525,1632015,0,0,0
2015-07-27,0.74,739156,544485,1283641,0,0,0
2015-07-28,0.62,794616,495239,1289855,0,0,0
2015-07-29,0.62,895660,559486,1455146,0,0,0
2015-07-30,0.5,931308,468036,1399344,0,0,0
2015-07-31,0.68,778472,532348,1310820,0,0,0
2015-08-03,0.73,775995,569751,1345746,0,0,0
2015-08-04,0.75,811805,610690,1422495,0,0,0
2015-08-05,0.77,899234,688704,1587938,0,0,0
2015-08-06,0.82,835307,684295,1519602,0,0,0
2015-08-07,0.83,711962,591001,1302963,0,0,0
2015-08-10,0.66,706076,463493,1169569,0,0,0
2015-08-11,0.79,775401,609468,1384869,0,0,0
2015-08-12,0.83,887955,736374,1624329,0,0,0
2015-08-13,0.74,640879,473653,1114532,0,0,0
2015-08-14,0.67,647314,436409,1083723,0,0,0
2015-08-17,0.69,850654,590599,1441253,0,0,0
2015-08-18,0.66,576344,378749,955093,0,0,0
2015-08-19,0.81,707568,573359,1280927,0,0,0
2015-08-20,0.82,953837,780901,1734738,0,0,0
2015-08-21,1.04,1255393,1304012,2559405,0,0,0
2015-08-24,0.87,1002932,876166,1879098,0,0,0
2015-08-25,0.7,852856,595154,1448010,0,0,0
2015-08-26,0.85,810339,687228,1497567,0,0,0
2015-08-27,0.76,941270,713020,1654290,0,0,0
2015-08-28,0.72,726296,524450,1250746,0,0,0
2015-08-31,0.66,588595,386287,974882,0,0,0
2015-09-01,0.74,738242,544548,1282790,0,0,0
2015-09-02,0.73,663121,481877,1144998,0,0,0
2015-09-03,0.68,617988,421553,1039541,0,0,0
2015-09-04,0.89,535567,475878,1011445,0,0,0
2015-09-08,0.66,622117,408701,1030818,0,0,0
2015-09-09,0.71,892082,636770,1528852,0,0,0
2015-09-10,0.77,633412,488693,1122105,0,0,0
2015-09-11,0.81,561230,453314,1014544,0,0,0
2015-09-14,0.91,637942,580297,1218239,0,0,0
2015-09-15,0.87,787708,681650,1469358,0,0,0
2015-09-16,0.73,760840,557526,1318366,0,0,0
2015-09-17,0.74,877049,651203,1528252,0,0,0
2015-09-18,0.83,911801,759499,1671300,0,0,0
2015-09-21,0.55,768851,423956,1192807,0,0,0
2015-09-22,0.8,596135,474526,1070661,0,0,0
2015-09-23,0.69,538719,373969,912688,0,0,0
2015-09-24,0.86,647767,559508,1207275,0,0,0
2015-09-25,0.74,661635,492306,1153941,0,0,0
2015-09-28,0.94,589762,552872,1142634,0,0,0
2015-09-29,0.95,574740,543951,1118691,0,0,0
2015-09-30,0.7,595452,416425,1011877,0,0,0
2015-10-01,0.73,600173,437216,1037389,0,0,0
2015-10-02,0.67,835496,560257,1395753,0,0,0
2015-10-05,0.62,813612,501108,1314720,0,0,0
2015-10-06,0.68,657878,447637,1105515,0,0,0
2015-10-07,0.83,726649,600156,1326805,0,0,0
2015-10-08,0.7,712465,501224,1213689,0,0,0
2015-10-09,0.64,720690,461592,1182282,0,0,0
2015-10-12,0.67,519574,346328,865902,0,0,0
2015-10-13,0.8,565079,452778,1017857,0,0,0
2015-10-14,0.75,691344,518053,1209397,0,0,0
2015-10-15,0.87,945970,818784,1764754,0,0,0
2015-10-16,0.61,1363144,830396,2193540,0,0,0
2015-10-19,0.67,752685,507421,1260106,0,0,0
2015-10-20,0.7,698740,487702,1186442,0,0,0
2015-10-21,0.83,685376,566036,1251412,0,0,0
2015-10-22,0.66,819713,541564,1361277,0,0,0
2015-10-23,0.63,1035678,650879,1686557,0,0,0
2015-10-26,0.72,897008,643928,1540936,0,0,0
2015-10-27,0.74,861273,634188,1495461,0,0,0
2015-10-28,0.54,1163315,629839,1793154,0,0,0
2015-10-29,0.56,920482,517364,1437846,0,0,0
2015-10-30,0.59,1144803,680230,1825033,0,0,0
2015-11-02,0.58,777267,454662,1231929,0,0,0
2015-11-03,0.71,912338,643232,1555570,0,0,0
2015-11-04,0.73,832515,605926,1438441,0,0,0
2015-11-05,0.63,1050123,662047,1712170,0,0,0
2015-11-06,0.66,1069349,706384,1775733,0,0,0
2015-11-09,0.76,770184,586808,1356992,0,0,0
2015-11-10,0.8,926296,744623,1670919,0,0,0
2015-11-11,0.59,860814,510799,1371613,0,0,0
2015-11-12,0.83,936647,775492,1712139,0,0,0
2015-11-13,0.98,868792,852000,1720792,0,0,0
2015-11-16,0.71,726547,514674,1241221,0,0,0
2015-11-17,0.83,953324,787142,1740466,0,0,0
2015-11-18,0.72,1099615,794659,1894274,0,0,0
2015-11-19,0.79,1066858,847678,1914536,0,0,0
2015-11-20,0.67,937195,631869,1569064,0,0,0
2015-11-23,0.6,705529,425957,1131486,0,0,0
2015-11-24,0.67,618712,414932,1033644,0,0,0
2015-11-25,0.65,532578,347036,879614,0,0,0
2015-11-27,0.76,258517,197134,455651,0,0,0
2015-11-30,0.65,526165,342278,868443,0,0,0
2015-12-01,0.61,594385,363997,958382,0,0,0
2015-12-02,0.67,658852,442130,1100982,0,0,0
2015-12-03,0.9,601369,538969,1140338,0,0,0
2015-12-04,0.61,712072,436353,1148425,0,0,0
2015-12-07,0.83,583081,482396,1065477,0,0,0
2015-12-08,0.96,506864,487429,994293,0,0,0
2015-12-09,0.66,654713,433836,1088549,0,0,0
2015-12-10,0.72,496637,359265,855902,0,0,0
2015-12-11,0.92,756163,694792,1450955,0,0,0
2015-12-14,0.57,1423704,817803,2241507,0,0,0
2015-12-15,0.66,828132,548624,1376756,0,0,0
2015-12-16,0.54,1009497,548574,1558071,0,0,0
2015-12-17,0.77,759912,585243,1345155,0,0,0
2015-12-18,0.77,1202971,927371,2130342,0,0,0
2015-12-21,0.64,654244,418672,1072916,0,0,0
2015-12-22,0.56,626858,350080,976938,0,0,0
2015-12-23,0.56,689362,387942,1077304,0,0,0
2015-12-24,0.57,329158,188972,518130,0,0,0
2015-12-28,1.21,415808,504746,920554,0,0,0
2015-12-29,0.54,522386,280795,803181,0,0,0
2015-12-30,0.59,530003,314592,844595,0,0,0
2015-12-31,0.69,550810,380480,931290,0,0,0
2016-01-04,0.8,775278,618316,1393594,0,0,0
2016-01-05,0.65,685261,447300,1132561,0,0,0
2016-01-06,0.7,795913,556943,1352856,0,0,0
2016-01-07,0.89,936704,832730,1769434,0,0,0
2016-01-08,0.93,805323,745261,1550584,0,0,0
2016-01-11,0.94,788011,740361,1528372,0,0,0
2016-01-12,0.86,726015,625189,1351204,0,0,0
2016-01-13,0.91,738452,675682,1414134,0,0,0
2016-01-14,0.82,1529365,1250783,2780148,0,0,0
2016-01-15,1.14,977462,1110422,2087884,0,0,0
2016-01-19,0.62,809527,503120,1312647,0,0,0
2016-01-20,0.59,1156918,682213,1839131,0,0,0
2016-01-21,0.69,742255,515502,1257757,0,0,0
2016-01-22,0.64,845652,542233,1387885,0,0,0
2016-01-25,0.69,655665,453984,1109649,0,0,0
2016-01-26,0.62,724081,447812,1171893,0,0,0
2016-01-27,0.71,865712,613916,1479628,0,0,0
2016-01-28,0.62,871135,543920,1415055,0,0,0
2016-01-29,0.58,1003313,584115,1587428,0,0,0
2016-02-01,0.63,626244,392746,1018990,0,0,0
2016-02-02,0.76,630169,477820,1107989,0,0,0
2016-02-03,0.82,739416,609491,1348907,0,0,0
2016-02-04,0.75,861435,642858,1504293,0,0,0
2016-02-05,0.92,759650,701507,1461157,0,0,0
2016-02-08,0.93,720050,672462,1392512,0,0,0
2016-02-09,0.76,686451,523896,1210347,0,0,0
2016-02-10,0.78,667836,519966,1187802,0,0,0
2016-02-11,0.96,784297,749463,1533760,0,0,0
2016-02-12,0.71,810883,573994,1384877,0,0,0
2016-02-16,0.8,701563,558658,1260221,0,0,0
2016-02-17,0.68,882426,597779,1480205,0,0,0
2016-02-18,0.75,695091,518206,1213297,0,0,0
2016-02-19,0.87,1140734,998046,2138780,0,0,0
2016-02-22,0.58,806315,463986,1270301,0,0,0
2016-02-23,0.71,602882,429382,1032264,0,0,0
2016-02-24,0.71,754038,533065,1287103,0,0,0
2016-02-25,0.62,632738,393838,1026576,0,0,0
2016-02-26,0.64,815309,520333,1335642,0,0,0
2016-02-29,0.6,602125,363665,965790,0,0,0
2016-03-01,0.68,724475,490587,1215062,0,0,0
2016-03-02,0.64,783787,499105,1282892,0,0,0
2016-03-03,0.55,887285,488850,1376135,0,0,0
2016-03-04,0.59,1175072,693598,1868670,0,0,0
2016-03-07,0.67,766497,513072,1279569,0,0,0
2016-03-08,0.9,539457,484756,1024213,0,0,0
2016-03-09,0.68,606850,411459,1018309,0,0,0
2016-03-10,0.74,608375,447734,1056109,0,0,0
2016-03-11,0.6,811985,483356,1295341,0,0,0
2016-03-14,0.69,603636,415565,1019201,0,0,0
2016-03-15,0.85,602936,512890,1115826,0,0,0
2016-03-16,0.71,695994,491825,1187819,0,0,0
2016-03-17,0.63,914149,575112,1489261,0,0,0
2016-03-18,0.55,1218012,663868,1881880,0,0,0
2016-03-21,0.71,527615,376417,904032,0,0,0
2016-03-22,0.88,584139,513263,1097402,0,0,0
2016-03-23,0.84,600767,506295,1107062,0,0,0
2016-03-24,0.82,617616,507322,1124938,0,0,0
2016-03-28,0.66,508126,333607,841733,0,0,0
2016-03-29,0.61,698255,423600,1121855,0,0,0
2016-03-30,0.62,675223,415467,1090690,0,0,0
2016-03-31,0.68,540195,369225,909420,0,0,0
2016-04-01,0.63,643158,404404,1047562,0,0,0
2016-04-04,0.65,604114,392893,997007,0,0,0
2016-04-05,0.69,564527,390906,955433,0,0,0
2016-04-06,0.61,588174,356712,944886,0,0,0
2016-04-07,0.68,720321,491071,1211392,0,0,0
2016-04-08,0.75,627216,467361,1094577,0,0,0
2016-04-11,0.65,592780,386902,979682,0,0,0
2016-04-12,0.72,726756,526897,1253653,0,0,0
2016-04-13,0.61,961493,582561,1544054,0,0,0
2016-04-14,0.68,781226,534856,1316082,0,0,0
2016-04-15,0.63,1026561,645511,1672072,0,0,0
2016-04-18,0.69,892475,612637,1505112,0,0,0
2016-04-19,0.67,827042,553101,1380143,0,0,0
2016-04-20,0.68,756168,514252,1270420,0,0,0
2016-04-21,0.85,716250,610703,1326953,0,0,0
2016-04-22,0.61,931151,565952,1497103,0,0,0
2016-04-25,0.7,617144,433109,1050253,0,0,0
2016-04-26,0.53,872326,458647,1330973,0,0,0
2016-04-27,0.55,1129116,619620,1748736,0,0,0
2016-04-28,0.77,1036492,800515,1837007,0,0,0
2016-04-29,0.86,954673,817026,1771699,0,0,0
2016-05-02,0.74,635725,470392,1106117,0,0,0
2016-05-03,0.77,755146,580693,1335839,0,0,0
2016-05-04,0.8,703647,562726,1266373,0,0,0
2016-05-05,0.8,708177,566734,1274911,0,0,0
2016-05-06,0.92,718072,659887,1377959,0,0,0
2016-05-09,0.86,617936,530655,1148591,0,0,0
2016-05-10,0.91,663565,602672,1266237,0,0,0
2016-05-11,0.8,597379,476924,1074303,0,0,0
2016-05-12,0.8,688668,550935,1239603,0,0,0
2016-05-13,0.84,697241,584639,1281880,0,0,0
2016-05-16,0.6,723416,431815,1155231,0,0,0
2016-05-17,0.81,669465,539064,1208529,0,0,0
2016-05-18,0.75,732150,552373,1284523,0,0,0
2016-05-19,0.8,727104,581805,1308909,0,0,0
2016-05-20,0.78,898943,704854,1603797,0,0,0
2016-05-23,0.65,733580,475412,1208992,0,0,0
2016-05-24,0.6,712838,426691,1139529,0,0,0
2016-05-25,0.62,822999,511648,1334647,0,0,0
2016-05-26,0.55,749704,415415,1165119,0,0,0
2016-05-27,0.51,706435,358495,1064930,0,0,0
2016-05-31,0.58,694070,399620,1093690,0,0,0
2016-06-01,0.55,694650,385270,1079920,0,0,0
2016-06-02,0.69,662424,459196,1121620,0,0,0
2016-06-03,0.59,792987,470591,1263578,0,0,0
2016-06-06,0.59,646574,382361,1028935,0,0,0
2016-06-07,0.61,687728,417695,1105423,0,0,0
2016-06-08,0.59,656375,389764,1046139,0,0,0
2016-06-09,0.72,620328,446348,1066676,0,0,0
2016-06-10,0.81,747038,608020,1355058,0,0,0
2016-06-13,0.75,643171,482939,1126110,0,0,0
2016-06-14,0.79,686208,540641,1226849,0,0,0
2016-06-15,0.68,664323,449184,1113507,0,0,0
2016-06-16,0.77,728333,563198,1291531,0,0,0
2016-06-17,0.63,918995,577087,1496082,0,0,0
2016-06-20,0.6,710358,425416,1135774,0,0,0
2016-06-21,0.64,628619,403696,1032315,0,0,0
2016-06-22,0.77,551054,424543,975597,0,0,0
2016-06-23,0.61,615854,376271,992125,0,0,0
2016-06-24,1.01,835430,842349,1677779,0,0,0
2016-06-27,0.81,876090,713937,1590027,0,0,0
2016-06-28,0.59,770826,458582,1229408,0,0,0
2016-06-29,0.58,773078,445745,1218823,0,0,0
2016-06-30,0.65,743779,480502,1224281,0,0,0
2016-07-01,0.57,828860,472896,1301756,0,0,0
2016-07-05,0.73,591119,432070,1023189,0,0,0
2016-07-06,0.76,662230,501918,1164148,0,0,0
2016-07-07,0.6,723234,435767,1159001,0,0,0
2016-07-08,0.52,896569,468793,1365362,0,0,0
2016-07-11,0.58,850368,490810,1341178,0,0,0
2016-07-12,0.59,921353,542039,1463392,0,0,0
2016-07-13,0.56,737280,413248,1150528,0,0,0
2016-07-14,0.53,993624,528928,1522552,0,0,0
2016-07-15,0.52,926637,484334,1410971,0,0,0
2016-07-18,0.69,822066,567901,1389967,0,0,0
2016-07-19,0.67,820937,549197,1370134,0,0,0
2016-07-20,0.57,850542,485327,1335869,0,0,0
2016-07-21,0.61,834207,506596,1340803,0,0,0
2016-07-22,0.59,826222,490338,1316560,0,0,0
2016-07-25,0.71,695060,496212,1191272,0,0,0
2016-07-26,0.76,827104,631687,1458791,0,0,0
2016-07-27,0.66,974749,647552,1622301,0,0,0
2016-07-28,0.62,967086,596175,1563261,0,0,0
2016-07-29,0.62,873187,543734,1416921,0,0,0
2016-08-01,0.72,740096,530680,1270776,0,0,0
2016-08-02,0.72,737879,530144,1268023,0,0,0
2016-08-03,0.59,748938,442592,1191530,0,0,0
2016-08-04,0.65,739840,481424,1221264,0,0,0
2016-08-05,0.52,1022028,531228,1553256,0,0,0
2016-08-08,0.58,750977,435289,1186266,0,0,0
2016-08-09,0.61,698791,425168,1123959,0,0,0
2016-08-10,0.62,737217,458047,1195264,0,0,0
2016-08-11,0.61,771884,470446,1242330,0,0,0
2016-08-12,0.55,911645,501840,1413485,0,0,0
2016-08-15,0.51,965214,493750,1458964,0,0,0
2016-08-16,0.7,747106,522222,1269328,0,0,0
2016-08-17,0.59,868309,512240,1380549,0,0,0
2016-08-18,0.54,877349,476108,1353457,0,0,0
2016-08-19,0.6,939736,563858,1503594,0,0,0
2016-08-22,0.63,756508,474126,1230634,0,0,0
2016-08-23,0.56,746566,416434,1163000,0,0,0
2016-08-24,0.68,751994,509852,1261846,0,0,0
2016-08-25,0.75,621103,467199,1088302,0,0,0
2016-08-26,0.73,807128,587221,1394349,0,0,0
2016-08-29,0.6,665523,399625,1065148,0,0,0
2016-08-30,0.63,675596,423609,1099205,0,0,0
2016-08-31,0.7,666219,468917,1135136,0,0,0
2016-09-01,0.7,776773,542755,1319528,0,0,0
2016-09-02,0.61,817271,500179,1317450,0,0,0
2016-09-06,0.5,990330,498767,1489097,0,0,0
2016-09-07,0.57,822356,468161,1290517,0,0,0
2016-09-08,0.61,903643,551326,1454969,0,0,0
2016-09-09,0.78,1125556,883019,2008575,0,0,0
2016-09-12,0.64,748046,480659,1228705,0,0,0
2016-09-13,0.75,703006,529361,1232367,0,0,0
2016-09-14,0.55,949120,519484,1468604,0,0,0
2016-09-15,0.7,949130,667398,1616528,0,0,0
2016-09-16,0.65,1044130,674824,1718954,0,0,0
2016-09-19,0.56,931342,520501,1451843,0,0,0
2016-09-20,0.66,608669,402876,1011545,0,0,0
2016-09-21,0.63,785710,495530,1281240,0,0,0
2016-09-22,0.57,829701,476707,1306408,0,0,0
2016-09-23,0.65,904399,587980,1492379,0,0,0
2016-09-26,0.73,775354,569501,1344855,0,0,0
2016-09-27,0.62,750006,465212,1215218,0,0,0
2016-09-28,0.65,784449,508014,1292463,0,0,0
2016-09-29,0.74,853347,629331,1482678,0,0,0
2016-09-30,0.61,990168,606949,1597117,0,0,0
2016-10-03,0.64,518965,332215,851180,0,0,0
2016-10-04,0.51,805202,410635,1215837,0,0,0
2016-10-05,0.58,770896,449241,1220137,0,0,0
2016-10-06,0.71,793870,565689,1359559,0,0,0
2016-10-07,0.68,634927,434574,1069501,0,0,0
2016-10-10,0.61,649928,397117,1047045,0,0,0
2016-10-11,0.75,650116,489432,1139548,0,0,0
2016-10-12,0.64,537188,345367,882555,0,0,0
2016-10-13,0.71,669402,476717,1146119,0,0,0
2016-10-14,0.68,715484,488875,1204359,0,0,0
2016-10-17,0.62,677746,417696,1095442,0,0,0
2016-10-18,0.69,654468,451936,1106404,0,0,0
2016-10-19,0.59,882679,522220,1404899,0,0,0
2016-10-20,0.53,978152,513764,1491916,0,0,0
2016-10-21,0.56,1249229,695914,1945143,0,0,0
2016-10-24,0.59,877340,516812,1394152,0,0,0
2016-10-25,0.69,839103,577599,1416702,0,0,0
2016-10-26,0.73,781276,572257,1353533,0,0,0
2016-10-27,0.55,1024239,563813,1588052,0,0,0
2016-10-28,0.78,886789,689802,1576591,0,0,0
2016-10-31,0.75,605766,454430,1060196,0,0,0
2016-11-01,0.86,700198,604605,1304803,0,0,0
2016-11-02,0.99,702186,697220,1399406,0,0,0
2016-11-03,0.74,750895,558889,1309784,0,0,0
2016-11-04,0.7,951739,666015,1617754,0,0,0
2016-11-07,0.68,635221,435001,1070222,0,0,0
2016-11-08,0.69,610080,422844,1032924,0,0,0
2016-11-09,0.61,1133177,695764,1828941,0,0,0
2016-11-10,0.6,1387868,827502,2215370,0,0,0
2016-11-11,0.53,1178997,624523,1803520,0,0,0
2016-11-14,0.57,1204761,681461,1886222,0,0,0
2016-11-15,0.51,1034658,530572,1565230,0,0,0
2016-11-16,0.63,881406,558848,1440254,0,0,0
2016-11-17,0.65,984385,635296,1619681,0,0,0
2016-11-18,0.68,1001409,678807,1680216,0,0,0
2016-11-21,0.57,852475,483528,1336003,0,0,0
2016-11-22,0.63,874720,551658,1426378,0,0,0
2016-11-23,0.6,717560,432386,1149946,0,0,0
2016-11-25,0.61,420124,257802,677926,0,0,0
2016-11-28,0.57,770092,436091,1206183,0,0,0
2016-11-29,0.62,675253,418811,1094064,0,0,0
2016-11-30,0.54,885783,482739,1368522,0,0,0
2016-12-01,0.66,927413,616365,1543778,0,0,0
2016-12-02,0.67,763577,512573,1276150,0,0,0
2016-12-05,0.63,691376,435628,1127004,0,0,0
2016-12-06,0.58,677211,393141,1070352,0,0,0
2016-12-07,0.46,1080700,500973,1581673,0,0,0
2016-12-08,0.5,959884,482539,1442423,0,0,0
2016-12-09,0.53,1034013,543691,1577704,0,0,0
2016-12-12,0.57,803449,455794,1259243,0,0,0
2016-12-13,0.54,898833,486168,1385001,0,0,0
2016-12-14,0.58,849456,495316,1344772,0,0,0
2016-12-15,0.59,893624,527194,1420818,0,0,0
2016-12-16,0.62,1111475,683760,1795235,0,0,0
2016-12-19,0.71,728173,519589,1247762,0,0,0
2016-12-20,0.63,662001,418773,1080774,0,0,0
2016-12-21,0.77,551226,423518,974744,0,0,0
2016-12-22,0.67,592270,395947,988217,0,0,0
2016-12-23,0.66,506980,335134,842114,0,0,0
2016-12-27,0.62,530659,326986,857645,0,0,0
2016-12-28,0.61,536793,329357,866150,0,0,0
2016-12-29,0.62,569581,351566,921147,0,0,0
2016-12-30,0.76,592557,449912,1042469,0,0,0
2017-01-03,0.69,649779,445569,1095348,0,0,0
2017-01-04,0.64,687394,439978,1127372,0,0,0
2017-01-05,0.69,692416,478639,1171055,0,0,0
2017-01-06,0.68,803336,543756,1347092,0,0,0
2017-01-09,0.62,674531,416135,1090666,0,0,0
2017-01-10,0.64,668871,430665,1099536,0,0,0
2017-01-11,0.63,656952,411845,1068797,0,0,0
2017-01-12,0.68,656569,446356,1102925,0,0,0
2017-01-13,0.63,818442,518086,1336528,0,0,0
2017-01-17,0.65,778913,505014,1283927,0,0,0
2017-01-18,0.67,727069,487307,1214376,0,0,0
2017-01-19,0.56,969284,538164,1507448,0,0,0
2017-01-20,0.7,1125737,784988,1910725,0,0,0
2017-01-23,0.72,813314,584599,1397913,0,0,0
2017-01-24,0.65,920828,602018,1522846,0,0,0
2017-01-25,0.61,948681,575321,1524002,0,0,0
2017-01-26,0.65,936991,606704,1543695,0,0,0
2017-01-27,0.73,854832,625207,1480039,0,0,0
2017-01-30,0.82,653551,536980,1190531,0,0,0
2017-01-31,0.7,794933,557893,1352826,0,0,0
2017-02-01,0.71,903202,640885,1544087,0,0,0
2017-02-02,0.64,871496,556167,1427663,0,0,0
2017-02-03,0.68,881636,603265,1484901,0,0,0
2017-02-06,0.75,657170,490641,1147811,0,0,0
2017-02-07,0.7,794053,552194,1346247,0,0,0
2017-02-08,0.69,773686,532845,1306531,0,0,0
2017-02-09,0.58,993540,572091,1565631,0,0,0
2017-02-10,0.7,856881,599940,1456821,0,0,0
2017-02-13,0.61,865227,523520,1388747,0,0,0
2017-02-14,0.53,984271,518164,1502435,0,0,0
2017-02-15,0.58,1009984,589613,1599597,0,0,0
2017-02-16,0.54,952816,510622,1463438,0,0,0
2017-02-17,0.59,1092005,641036,1733041,0,0,0
2017-02-21,0.61,927005,567307,1494312,0,0,0
2017-02-22,0.6,847068,506663,1353731,0,0,0
2017-02-23,0.62,911460,567903,1479363,0,0,0
2017-02-24,0.72,852693,615915,1468608,0,0,0
2017-02-27,0.63,774156,484472,1258628,0,0,0
2017-02-28,0.7,739604,515112,1254716,0,0,0
2017-03-01,0.53,1205822,639721,1845543,0,0,0
2017-03-02,0.56,1032128,581908,1614036,0,0,0
2017-03-03,0.7,881610,619489,1501099,0,0,0
2017-03-06,0.67,803109,540454,1343563,0,0,0
2017-03-07,0.54,869076,468457,1337533,0,0,0
2017-03-08,0.62,868836,539360,1408196,0,0,0
2017-03-09,0.72,735507,526787,1262294,0,0,0
2017-03-10,0.57,903793,511666,1415459,0,0,0
2017-03-13,0.7,707320,496333,1203653,0,0,0
2017-03-14,0.73,666485,489700,1156185,0,0,0
2017-03-15,0.61,823472,500625,1324097,0,0,0
2017-03-16,0.57,876658,501491,1378149,0,0,0
2017-03-17,0.61,1176177,717936,1894113,0,0,0
2017-03-20,0.64,914014,588278,1502292,0,0,0
2017-03-21,0.79,1032128,814873,1847001,0,0,0
2017-03-22,0.73,754341,551384,1305725,0,0,0
2017-03-23,0.67,687968,463318,1151286,0,0,0
2017-03-24,0.69,760823,525693,1286516,0,0,0
2017-03-27,0.58,530483,308746,839229,0,0,0
2017-03-28,0.6,741957,444008,1185965,0,0,0
2017-03-29,0.54,762292,411210,1173502,0,0,0
2017-03-30,0.58,758297,441001,1199298,0,0,0
2017-03-31,0.56,790248,443073,1233321,0,0,0
2017-04-03,0.67,694779,464319,1159098,0,0,0
2017-04-04,0.62,651097,405812,1056909,0,0,0
2017-04-05,0.61,818417,496230,1314647,0,0,0
2017-04-06,0.66,635136,417391,1052527,0,0,0
2017-04-07,0.67,650754,432830,1083584,0,0,0
2017-04-10,0.62,643952,396670,1040622,0,0,0
2017-04-11,0.79,626999,497752,1124751,0,0,0
2017-04-12,0.69,633668,439276,1072944,0,0,0
2017-04-13,0.96,733434,703632,1437066,0,0,0
2017-04-17,0.63,664972,420194,1085166,0,0,0
2017-04-18,0.62,687485,429472,1116957,0,0,0
2017-04-19,0.7,713030,499195,1212225,0,0,0
2017-04-20,0.68,885010,600274,1485284,0,0,0
2017-04-21,0.67,980905,655836,1636741,0,0,0
2017-04-24,0.61,893517,544187,1437704,0,0,0
2017-04-25,0.61,1064307,646103,1710410,0,0,0
2017-04-26,0.63,841489,526082,1367571,0,0,0
2017-04-27,0.72,865201,627016,1492217,0,0,0
2017-04-28,0.68,1006433,687084,1693517,0,0,0
2017-05-01,0.62,799184,495378,1294562,0,0,0
2017-05-02,0.61,940053,572180,1512233,0,0,0
2017-05-03,0.69,907589,623196,1530785,0,0,0
2017-05-04,0.77,848531,651056,1499587,0,0,0
2017-05-05,0.64,862095,550581,1412676,0,0,0
2017-05-08,0.6,901718,538953,1440671,0,0,0
2017-05-09,0.63,940967,596282,1537249,0,0,0
2017-05-10,0.62,964876,596428,1561304,0,0,0
2017-05-11,0.65,937125,608303,1545428,0,0,0
2017-05-12,0.57,998126,566590,1564716,0,0,0
2017-05-15,0.55,993848,545842,1539690,0,0,0
2017-05-16,0.54,1138431,616836,1755267,0,0,0
2017-05-17,0.73,1168038,851371,2019409,0,0,0
2017-05-18,0.7,1044532,734306,1778838,0,0,0
2017-05-19,0.62,1105507,684075,1789582,0,0,0
2017-05-22,0.54,923272,496667,1419939,0,0,0
2017-05-23,0.6,813357,489108,1302465,0,0,0
2017-05-24,0.62,822776,510187,1332963,0,0,0
2017-05-25,0.59,1003599,595306,1598905,0,0,0
2017-05-26,0.64,780023,501670,1281693,0,0,0
2017-05-30,0.68,772623,526611,1299234,0,0,0
2017-05-31,0.63,837375,525667,1363042,0,0,0
2017-06-01,0.66,801253,526473,1327726,0,0,0
2017-06-02,0.6,930484,560803,1491287,0,0,0
2017-06-05,0.51,1013742,512819,1526561,0,0,0
2017-06-06,0.59,842134,497741,1339875,0,0,0
2017-06-07,0.58,832055,482770,1314825,0,0,0
2017-06-08,0.55,1059364,578765,1638129,0,0,0
2017-06-09,0.72,1345032,961963,2306995,0,0,0
2017-06-12,0.68,983309,667330,1650639,0,0,0
2017-06-13,0.64,743779,479193,1222972,0,0,0
2017-06-14,0.67,856105,570694,1426799,0,0,0
2017-06-15,0.8,864450,692107,1556557,0,0,0
2017-06-16,0.67,1021601,685519,1707120,0,0,0
2017-06-19,0.58,889433,516826,1406259,0,0,0
2017-06-20,0.72,702015,507122,1209137,0,0,0
2017-06-21,0.59,899739,527501,1427240,0,0,0
2017-06-22,0.5,991540,497405,1488945,0,0,0
2017-06-23,0.58,943495,543762,1487257,0,0,0
2017-06-26,0.64,777739,495882,1273621,0,0,0
2017-06-27,0.6,826466,497545,1324011,0,0,0
2017-06-28,0.68,815362,552385,1367747,0,0,0
2017-06-29,0.69,1078088,741777,1819865,0,0,0
2017-06-30,0.67,785145,525699,1310844,0,0,0
2017-07-03,0.55,479605,265739,745344,0,0,0
2017-07-05,0.61,686910,421687,1108597,0,0,0
2017-07-06,0.65,730025,476425,1206450,0,0,0
2017-07-07,0.66,895055,586846,1481901,0,0,0
2017-07-10,0.64,733531,468929,1202460,0,0,0
2017-07-11,0.69,648196,449863,1098059,0,0,0
2017-07-12,0.6,821639,491455,1313094,0,0,0
2017-07-13,0.62,868563,541563,1410126,0,0,0
2017-07-14,0.53,976652,520244,1496896,0,0,0
2017-07-17,0.63,782777,489244,1272021,0,0,0
2017-07-18,0.62,911208,561487,1472695,0,0,0
2017-07-19,0.56,1015147,569726,1584873,0,0,0
2017-07-20,0.53,1006735,534242,1540977,0,0,0
2017-07-21,0.56,1174275,660107,1834382,0,0,0
2017-07-24,0.68,813899,551470,1365369,0,0,0
2017-07-25,0.61,1080571,657035,1737606,0,0,0
2017-07-26,0.65,982399,642698,1625097,0,0,0
2017-07-27,0.71,1240558,883189,2123747,0,0,0
2017-07-28,0.63,1003684,630933,1634617,0,0,0
2017-07-31,0.62,802355,497551,1299906,0,0,0
2017-08-01,0.64,787418,503073,1290491,0,0,0
2017-08-02,0.75,942353,708985,1651338,0,0,0
2017-08-03,0.71,774741,547070,1321811,0,0,0
2017-08-04,0.66,892363,587528,1479891,0,0,0
2017-08-07,0.77,710500,545023,1255523,0,0,0
2017-08-08,0.67,920532,621127,1541659,0,0,0
2017-08-09,0.83,754195,628435,1382630,0,0,0
2017-08-10,0.88,823551,727178,1550729,0,0,0
2017-08-11,0.94,729994,687810,1417804,0,0,0
2017-08-14,0.59,692332,410095,1102427,0,0,0
2017-08-15,0.68,794282,543035,1337317,0,0,0
2017-08-16,0.62,816057,507342,1323399,0,0,0
2017-08-17,0.78,810283,632705,1442988,0,0,0
2017-08-18,0.82,899141,741621,1640762,0,0,0
2017-08-21,0.57,748374,424392,1172766,0,0,0
2017-08-22,0.55,802681,443776,1246457,0,0,0
2017-08-23,0.58,702663,406253,1108916,0,0,0
2017-08-24,0.69,658211,455653,1113864,0,0,0
2017-08-25,0.69,685990,471455,1157445,0,0,0
2017-08-28,0.55,668363,364369,1032732,0,0,0
2017-08-29,0.61,673057,411515,1084572,0,0,0
2017-08-30,0.57,708226,401363,1109589,0,0,0
2017-08-31,0.57,769923,439117,1209040,0,0,0
2017-09-01,0.56,863637,484585,1348222,0,0,0
2017-09-05,0.67,787424,531004,1318428,0,0,0
2017-09-06,0.56,716553,399029,1115582,0,0,0
2017-09-07,0.55,901271,496641,1397912,0,0,0
2017-09-08,0.73,830893,603930,1434823,0,0,0
2017-09-11,0.65,884162,578887,1463049,0,0,0
2017-09-12,0.58,999284,580890,1580174,0,0,0
2017-09-13,0.55,946228,517562,1463790,0,0,0
2017-09-14,0.56,930834,523494,1454328,0,0,0
2017-09-15,0.63,1054775,667640,1722415,0,0,0
2017-09-18,0.61,910932,559663,1470595,0,0,0
2017-09-19,0.67,742735,498026,1240761,0,0,0
2017-09-20,0.61,969882,594347,1564229,0,0,0
2017-09-21,0.66,781621,518848,1300469,0,0,0
2017-09-22,0.77,728184,557495,1285679,0,0,0
2017-09-25,0.64,917063,584122,1501185,0,0,0
2017-09-26,0.69,771111,531812,1302923,0,0,0
2017-09-27,0.61,868117,527812,1395929,0,0,0
2017-09-28,0.52,845078,436622,1281700,0,0,0
2017-09-29,0.59,841513,499101,1340614,0,0,0
2017-10-02,0.61,917661,563946,1481607,0,0,0
2017-10-03,0.66,812719,538382,1351101,0,0,0
2017-10-04,0.58,766713,448462,1215175,0,0,0
2017-10-05,0.69,818779,563503,1382282,0,0,0
2017-10-06,0.7,755229,527204,1282433,0,0,0
2017-10-09,0.73,746683,547340,1294023,0,0,0
2017-10-10,0.54,832289,452119,1284408,0,0,0
2017-10-11,0.62,735067,456975,1192042,0,0,0
2017-10-12,0.7,825744,577596,1403340,0,0,0
2017-10-13,0.65,953477,619436,1572913,0,0,0
2017-10-16,0.7,838935,583332,1422267,0,0,0
2017-10-17,0.66,923267,613431,1536698,0,0,0
2017-10-18,0.72,927101,667445,1594546,0,0,0
2017-10-19,0.7,1047186,729656,1776842,0,0,0
2017-10-20,0.6,1356600,816522,2173122,0,0,0
2017-10-23,0.65,1011712,656849,1668561,0,0,0
2017-10-24,0.63,973185,609293,1582478,0,0,0
2017-10-25,0.71,930982,657223,1588205,0,0,0
2017-10-26,0.61,1077235,660915,1738150,0,0,0
2017-10-27,0.55,1441991,793570,2235561,0,0,0
2017-10-30,0.69,973363,667203,1640566,0,0,0
2017-10-31,0.57,986299,567090,1553389,0,0,0
2017-11-01,0.71,1088633,771145,1859778,0,0,0
2017-11-02,0.63,1067367,669943,1737310,0,0,0
2017-11-03,0.6,1100554,661987,1762541,0,0,0
2017-11-06,0.61,1127011,685571,1812582,0,0,0
2017-11-07,0.64,961060,611395,1572455,0,0,0
2017-11-08,0.68,892461,609381,1501842,0,0,0
2017-11-09,0.64,1034980,658122,1693102,0,0,0
2017-11-10,0.66,904960,596367,1501327,0,0,0
2017-11-13,0.69,920230,632128,1552358,0,0,0
2017-11-14,0.62,999781,624467,1624248,0,0,0
2017-11-15,0.74,791806,584662,1376468,0,0,0
2017-11-16,0.64,1065905,687405,1753310,0,0,0
2017-11-17,0.56,1236983,694225,1931208,0,0,0
2017-11-20,0.59,905561,533482,1439043,0,0,0
2017-11-21,0.58,927766,534424,1462190,0,0,0
2017-11-22,0.57,827802,472575,1300377,0,0,0
2017-11-24,0.62,539670,335439,875109,0,0,0
2017-11-27,0.61,823800,505182,1328982,0,0,0
2017-11-28,0.5,1058682,532998,1591680,0,0,0
2017-11-29,0.52,1507452,776910,2284362,0,0,0
2017-11-30,0.55,1124636,616211,1740847,0,0,0
2017-12-01,0.63,905820,567231,1473051,0,0,0
2017-12-04,0.56,1158484,648666,1807150,0,0,0
2017-12-05,0.57,827228,468921,1296149,0,0,0
2017-12-06,0.67,751845,503753,1255598,0,0,0
2017-12-07,0.58,789415,457484,1246899,0,0,0
2017-12-08,0.6,843575,501996,1345571,0,0,0
2017-12-11,0.63,781234,495745,1276979,0,0,0
2017-12-12,0.51,1027042,526105,1553147,0,0,0
2017-12-13,0.57,904850,516195,1421045,0,0,0
2017-12-14,0.6,957317,577220,1534537,0,0,0
2017-12-15,0.57,1205472,688259,1893731,0,0,0
2017-12-18,0.5,1046262,521768,1568030,0,0,0
2017-12-19,0.53,857115,453987,1311102,0,0,0
2017-12-20,0.56,852844,474158,1327002,0,0,0
2017-12-21,0.56,847770,472857,1320627,0,0,0
2017-12-22,0.64,723795,464097,1187892,0,0,0
2017-12-26,0.58,608935,353448,962383,0,0,0
2017-12-27,0.55,577530,315080,892610,0,0,0
2017-12-28,0.57,545173,309655,854828,0,0,0
2017-12-29,0.59,729716,429703,1159419,0,0,0
2018-01-02,0.47,1076447,504836,1581283,0,0,0
2018-01-03,0.54,1139510,612481,1751991,0,0,0
2018-01-04,0.5,1305082,646239,1951321,0,0,0
2018-01-05,0.58,1157808,666466,1824274,0,0,0
2018-01-08,0.63,1091985,685608,1777593,0,0,0
2018-01-09,0.6,951490,569836,1521326,0,0,0
2018-01-10,0.65,966939,631357,1598296,0,0,0
2018-01-11,0.5,1252912,622089,1875001,0,0,0
2018-01-12,0.5,1432116,709975,2142091,0,0,0
2018-01-16,0.49,1417959,693397,2111356,0,0,0
2018-01-17,0.48,1293702,619137,1912839,0,0,0
2018-01-18,0.56,1162233,649195,1811428,0,0,0
2018-01-19,0.56,1502514,844728,2347242,0,0,0
2018-01-22,0.56,1177183,657283,1834466,0,0,0
2018-01-23,0.52,1264616,658747,1923363,0,0,0
2018-01-24,0.53,1412802,754059,2166861,0,0,0
2018-01-25,0.56,1159119,648083,1807202,0,0,0
2018-01-26,0.49,1389697,677907,2067604,0,0,0
2018-01-29,0.57,1110626,627804,1738430,0,0,0
2018-01-30,0.61,1021980,620521,1642501,0,0,0
2018-01-31,0.59,1070303,631533,1701836,0,0,0
2018-02-01,0.59,1071400,627629,1699029,0,0,0
2018-02-02,0.77,1128438,867766,1996204,0,0,0
2018-02-05,0.73,1100575,799847,1900422,0,0,0
2018-02-06,0.75,943886,711294,1655180,0,0,0
2018-02-07,0.68,879037,594585,1473622,0,0,0
2018-02-08,0.75,960633,725012,1685645,0,0,0
2018-02-09,0.88,1104508,967087,2071595,0,0,0
2018-02-12,0.67,839057,565147,1404204,0,0,0
2018-02-13,0.73,708555,515164,1223719,0,0,0
2018-02-14,0.59,1032427,611912,1644339,0,0,0
2018-02-15,0.61,1191199,727827,1919026,0,0,0
2018-02-16,0.52,1319454,691446,2010900,0,0,0
2018-02-20,0.66,961872,636916,1598788,0,0,0
2018-02-21,0.58,921300,535501,1456801,0,0,0
2018-02-22,0.63,877102,555462,1432564,0,0,0
2018-02-23,0.62,986461,607289,1593750,0,0,0
2018-02-26,0.59,1034829,614035,1648864,0,0,0
2018-02-27,0.63,894420,560256,1454676,0,0,0
2018-02-28,0.67,930206,622549,1552755,0,0,0
2018-03-01,0.72,1100954,791509,1892463,0,0,0
2018-03-02,0.71,1061712,758367,1820079,0,0,0
2018-03-05,0.55,934275,514775,1449050,0,0,0
2018-03-06,0.52,906597,472145,1378742,0,0,0
2018-03-07,0.58,870868,507156,1378024,0,0,0
2018-03-08,0.61,817333,498391,1315724,0,0,0
2018-03-09,0.53,1258947,671967,1930914,0,0,0
2018-03-12,0.57,1048292,598058,1646350,0,0,0
2018-03-13,0.57,1070713,615360,1686073,0,0,0
2018-03-14,0.69,866506,597685,1464191,0,0,0
2018-03-15,0.63,852703,532981,1385684,0,0,0
2018-03-16,0.63,1032425,654698,1687123,0,0,0
2018-03-19,0.67,967041,648646,1615687,0,0,0
2018-03-20,0.68,846066,578492,1424558,0,0,0
2018-03-21,0.62,826165,510571,1336736,0,0,0
2018-03-22,0.74,868595,643022,1511617,0,0,0
2018-03-23,0.76,1110198,848106,1958304,0,0,0
2018-03-26,0.63,959031,608120,1567151,0,0,0
2018-03-27,0.71,913665,649671,1563336,0,0,0
2018-03-28,0.68,845151,577929,1423080,0,0,0
2018-03-29,0.63,926248,582438,1508686,0,0,0
2018-04-02,0.77,764054,588316,1352370,0,0,0
2018-04-03,0.65,690499,449427,1139926,0,0,0
2018-04-04,0.63,760641,476721,1237362,0,0,0
2018-04-05,0.61,927532,569544,1497076,0,0,0
2018-04-06,0.76,766021,585394,1351415,0,0,0
2018-04-09,0.61,711361,432199,1143560,0,0,0
2018-04-10,0.57,838295,475223,1313518,0,0,0
2018-04-11,0.65,753405,491077,1244482,0,0,0
2018-04-12,0.66,868455,572499,1440954,0,0,0
2018-04-13,0.66,1050072,696700,1746772,0,0,0
2018-04-16,0.64,914223,583158,1497381,0,0,0
2018-04-17,0.68,1037912,708380,1746292,0,0,0
2018-04-18,0.56,1077154,604574,1681728,0,0,0
2018-04-19,0.64,1129542,728277,1857819,0,0,0
2018-04-20,0.65,1414881,913725,2328606,0,0,0
2018-04-23,0.61,902235,551357,1453592,0,0,0
2018-04-24,0.68,1014287,690493,1704780,0,0,0
2018-04-25,0.7,1056078,735513,1791591,0,0,0
2018-04-26,0.61,1264763,768857,2033620,0,0,0
2018-04-27,0.64,1190484,761371,1951855,0,0,0
2018-04-30,0.61,854217,524070,1378287,0,0,0
2018-05-01,0.68,772602,525886,1298488,0,0,0
2018-05-02,0.65,902455,586391,1488846,0,0,0
2018-05-03,0.76,938226,709407,1647633,0,0,0
2018-05-04,0.55,1136638,625971,1762609,0,0,0
2018-05-07,0.54,969102,522133,1491235,0,0,0
2018-05-08,0.61,804872,488489,1293361,0,0,0
2018-05-09,0.58,1138939,662698,1801637,0,0,0
2018-05-10,0.51,1109635,565811,1675446,0,0,0
2018-05-11,0.6,976251,585117,1561368,0,0,0
2018-05-14,0.62,932964,577082,1510046,0,0,0
2018-05-15,0.62,776102,480965,1257067,0,0,0
2018-05-16,0.5,990611,499498,1490109,0,0,0
2018-05-17,0.57,1057104,600947,1658051,0,0,0
2018-05-18,0.66,1092969,716839,1809808,0,0,0
2018-05-21,0.54,937777,507509,1445286,0,0,0
2018-05-22,0.58,903015,522857,1425872,0,0,0
2018-05-23,0.65,765565,495002,1260567,0,0,0
2018-05-24,0.64,902241,576382,1478623,0,0,0
2018-05-25,0.61,1027495,628076,1655571,0,0,0
2018-05-29,0.65,914287,595341,1509628,0,0,0
2018-05-30,0.56,917442,516448,1433890,0,0,0
2018-05-31,0.63,918325,578640,1496965,0,0,0
2018-06-01,0.56,1185033,664360,1849393,0,0,0
2018-06-04,0.55,1070798,587803,1658601,0,0,0
2018-06-05,0.48,1119436,534756,1654192,0,0,0
2018-06-06,0.53,1134561,596175,1730736,0,0,0
2018-06-07,0.56,1164971,656252,1821223,0,0,0
2018-06-08,0.6,1013083,606198,1619281,0,0,0
2018-06-11,0.54,1033475,558167,1591642,0,0,0
2018-06-12,0.5,1121773,556234,1678007,0,0,0
2018-06-13,0.54,1119311,606372,1725683,0,0,0
2018-06-14,0.5,1261302,629148,1890450,0,0,0
2018-06-15,0.61,1347480,826683,2174163,0,0,0
2018-06-18,0.54,1011610,545529,1557139,0,0,0
2018-06-19,0.59,1008678,597572,1606250,0,0,0
2018-06-20,0.56,1020741,575236,1595977,0,0,0
2018-06-21,0.56,1023040,575792,1598832,0,0,0
2018-06-22,0.56,1017163,574349,1591512,0,0,0
2018-06-25,0.61,1170048,712240,1882288,0,0,0
2018-06-26,0.52,987158,514092,1501250,0,0,0
2018-06-27,0.67,959777,640650,1600427,0,0,0
2018-06-28,0.65,784221,506913,1291134,0,0,0
2018-06-29,0.69,838924,581281,1420205,0,0,0
2018-07-02,0.58,648123,375428,1023551,0,0,0
2018-07-03,0.67,470195,312771,782966,0,0,0
2018-07-05,0.6,763068,460583,1223651,0,0,0
2018-07-06,0.57,871060,499995,1371055,0,0,0
2018-07-09,0.53,989968,523059,1513027,0,0,0
2018-07-10,0.74,756583,556971,1313554,0,0,0
2018-07-11,0.59,704583,418971,1123554,0,0,0
2018-07-12,0.56,946550,525993,1472543,0,0,0
2018-07-13,0.62,1102698,679760,1782458,0,0,0
2018-07-16,0.7,858956,604182,1463138,0,0,0
2018-07-17,0.65,908770,593431,1502201,0,0,0
2018-07-18,0.56,931611,519461,1451072,0,0,0
2018-07-19,0.62,1047570,650451,1698021,0,0,0
2018-07-20,0.66,1348533,895449,2243982,0,0,0
2018-07-23,0.55,1037451,567194,1604645,0,0,0
2018-07-24,0.63,1028864,647937,1676801,0,0,0
2018-07-25,0.61,1020610,619039,1639649,0,0,0
2018-07-26,0.63,1187715,748780,1936495,0,0,0
2018-07-27,0.67,1181334,789657,1970991,0,0,0
2018-07-30,0.72,989211,715707,1704918,0,0,0
2018-07-31,0.69,921499,637783,1559282,0,0,0
2018-08-01,0.67,972475,653474,1625949,0,0,0
2018-08-02,0.58,1231530,709735,1941265,0,0,0
2018-08-03,0.56,1043634,587821,1631455,0,0,0
2018-08-06,0.62,883603,550287,1433890,0,0,0
2018-08-07,0.64,963316,617763,1581079,0,0,0
2018-08-08,0.62,922686,571882,1494568,0,0,0
2018-08-09,0.62,987010,611652,1598662,0,0,0
2018-08-10,0.7,935697,652943,1588640,0,0,0
2018-08-13,0.64,865026,554120,1419146,0,0,0
2018-08-14,0.66,920750,609710,1530460,0,0,0
2018-08-15,0.66,1103165,728201,1831366,0,0,0
2018-08-16,0.6,1145049,687191,1832240,0,0,0
2018-08-17,0.7,1242892,867592,2110484,0,0,0
2018-08-20,0.55,1038005,569867,1607872,0,0,0
2018-08-21,0.58,932105,545101,1477206,0,0,0
2018-08-22,0.6,844777,503585,1348362,0,0,0
2018-08-23,0.61,989520,606644,1596164,0,0,0
2018-08-24,0.57,1019951,579479,1599430,0,0,0
2018-08-27,0.53,1204342,632416,1836758,0,0,0
2018-08-28,0.53,940682,500470,1441152,0,0,0
2018-08-29,0.55,1092654,597557,1690211,0,0,0
2018-08-30,0.58,1107857,645867,1753724,0,0,0
2018-08-31,0.63,1007700,633690,1641390,0,0,0
2018-09-04,0.59,1021076,604418,1625494,0,0,0
2018-09-05,0.62,1098548,684955,1783503,0,0,0
2018-09-06,0.74,1047128,774189,1821317,0,0,0
2018-09-07,0.69,1000715,686393,1687108,0,0,0
2018-09-10,0.62,844877,519797,1364674,0,0,0
2018-09-11,0.61,913473,556172,1469645,0,0,0
2018-09-12,0.55,1132988,625266,1758254,0,0,0
2018-09-13,0.5,1340299,669873,2010172,0,0,0
2018-09-14,0.58,1083914,624258,1708172,0,0,0
2018-09-17,0.64,917979,583455,1501434,0,0,0
2018-09-18,0.55,988476,546089,1534565,0,0,0
2018-09-19,0.57,1152609,661845,1814454,0,0,0
2018-09-20,0.56,1253679,703351,1957030,0,0,0
2018-09-21,0.57,1303787,737258,2041045,0,0,0
2018-09-24,0.63,885457,558660,1444117,0,0,0
2018-09-25,0.52,981752,509042,1490794,0,0,0
2018-09-26,0.59,931837,554063,1485900,0,0,0
2018-09-27,0.61,860657,521525,1382182,0,0,0
2018-09-28,0.64,1123618,717647,1841265,0,0,0
2018-10-01,0.57,979404,556812,1536216,0,0,0
2018-10-02,0.54,1000549,544094,1544643,0,0,0
2018-10-03,0.56,1034256,577107,1611363,0,0,0
2018-10-04,0.72,998160,713835,1711995,0,0,0
2018-10-05,0.84,1001382,837644,1839026,0,0,0
2018-10-08,0.66,879048,578116,1457164,0,0,0
2018-10-09,0.62,906730,558308,1465038,0,0,0
2018-10-10,0.74,1131971,838732,1970703,0,0,0
2018-10-11,0.68,1153572,788231,1941803,0,0,0
2018-10-12,0.67,1073127,715188,1788315,0,0,0
2018-10-15,0.61,821270,499956,1321226,0,0,0
2018-10-16,0.63,931375,583267,1514642,0,0,0
2018-10-17,0.68,915666,621882,1537548,0,0,0
2018-10-18,0.73,924537,679274,1603811,0,0,0
2018-10-19,0.82,1101743,906243,2007986,0,0,0
2018-10-22,0.57,907384,519810,1427194,0,0,0
2018-10-23,0.61,1165828,705894,1871722,0,0,0
2018-10-24,0.71,1121227,794647,1915874,0,0,0
2018-10-25,0.66,1182403,778374,1960777,0,0,0
2018-10-26,0.8,1153070,922536,2075606,0,0,0
2018-10-29,0.74,1036298,767001,1803299,0,0,0
2018-10-30,0.69,1121688,774001,1895689,0,0,0
2018-10-31,0.65,1147893,747335,1895228,0,0,0
2018-11-01,0.51,1349684,683966,2033650,0,0,0
2018-11-02,0.68,1218285,833458,2051743,0,0,0
2018-11-05,0.61,852962,518337,1371299,0,0,0
2018-11-06,0.67,751979,500980,1252959,0,0,0
2018-11-07,0.59,1137300,669016,1806316,0,0,0
2018-11-08,0.64,936771,596764,1533535,0,0,0
2018-11-09,0.8,1051286,836858,1888144,0,0,0
2018-11-12,0.73,861263,625188,1486451,0,0,0
2018-11-13,0.7,876613,613813,1490426,0,0,0
2018-11-14,0.81,951926,773688,1725614,0,0,0
2018-11-15,0.73,900049,659941,1559990,0,0,0
2018-11-16,0.74,1037595,763156,1800751,0,0,0
2018-11-19,0.72,932034,675303,1607337,0,0,0
2018-11-20,0.82,967305,794113,1761418,0,0,0
2018-11-21,0.73,670296,488856,1159152,0,0,0
2018-11-23,0.85,418598,357318,775916,0,0,0
2018-11-26,0.64,814666,519950,1334616,0,0,0
2018-11-27,0.7,694457,487038,1181495,0,0,0
2018-11-28,0.62,958428,593364,1551792,0,0,0
2018-11-29,0.57,886977,506021,1392998,0,0,0
2018-11-30,0.53,999559,526506,1526065,0,0,0
2018-12-03,0.57,1077314,609209,1686523,0,0,0
2018-12-04,0.69,910062,632459,1542521,0,0,0
2018-12-06,0.85,926238,787251,1713489,0,0,0
2018-12-07,0.77,952729,731755,1684484,0,0,0
2018-12-10,0.7,962080,670464,1632544,0,0,0
2018-12-11,0.65,663800,431283,1095083,0,0,0
2018-12-12,0.62,769190,475230,1244420,0,0,0
2018-12-13,0.75,668389,499556,1167945,0,0,0
2018-12-14,0.79,808892,639628,1448520,0,0,0
2018-12-17,0.97,675923,658420,1334343,0,0,0
2018-12-18,0.69,736892,507383,1244275,0,0,0
2018-12-19,0.85,754723,640131,1394854,0,0,0
2018-12-20,0.91,947724,865645,1813369,0,0,0
2018-12-21,1.13,879492,989679,1869171,0,0,0
2018-12-24,0.79,510716,403762,914478,0,0,0
2018-12-26,0.62,940209,585603,1525812,0,0,0
2018-12-27,0.73,738959,535793,1274752,0,0,0
2018-12-28,0.44,1126242,491363,1617605,0,0,0
2018-12-31,0.6,590501,356597,947098,0,0,0
2019-01-02,0.67,661620,441647,1103267,0,0,0
2019-01-03,0.73,855141,622457,1477598,0,0,0
2019-01-04,0.59,1252477,740897,1993374,0,0,0
2019-01-07,0.6,1014161,604667,1618828,0,0,0
2019-01-08,0.63,922520,583097,1505617,0,0,0
2019-01-09,0.59,1010544,600185,1610729,0,0,0
2019-01-10,0.65,895503,584037,1479540,0,0,0
2019-01-11,0.77,1108280,849105,1957385,0,0,0
2019-01-14,0.65,878155,568896,1447051,0,0,0
2019-01-15,0.7,932512,655126,1587638,0,0,0
2019-01-16,0.6,985591,591959,1577550,0,0,0
2019-01-17,0.52,1307123,679779,1986902,0,0,0
2019-01-18,0.54,1656518,895294,2551812,0,0,0
2019-01-22,0.64,1037183,666392,1703575,0,0,0
2019-01-23,0.64,878205,560465,1438670,0,0,0
2019-01-24,0.72,916000,655693,1571693,0,0,0
2019-01-25,0.51,1361308,696172,2057480,0,0,0
2019-01-28,0.76,820622,624306,1444928,0,0,0
2019-01-29,0.68,850592,575534,1426126,0,0,0
2019-01-30,0.63,1236083,780028,2016111,0,0,0
2019-01-31,0.53,1438657,762358,2201015,0,0,0
2019-02-01,0.6,1114041,671624,1785665,0,0,0
2019-02-04,0.6,1003638,597181,1600819,0,0,0
2019-02-05,0.56,1065048,599883,1664931,0,0,0
2019-02-06,0.64,1000045,640447,1640492,0,0,0
2019-02-07,0.7,1008551,706989,1715540,0,0,0
2019-02-08,0.61,1078626,662819,1741445,0,0,0
2019-02-11,0.6,768348,464223,1232571,0,0,0
2019-02-12,0.57,996011,570208,1566219,0,0,0
2019-02-13,0.57,1048740,596519,1645259,0,0,0
2019-02-14,0.6,998836,598491,1597327,0,0,0
2019-02-15,0.52,1310202,676710,1986912,0,0,0
2019-02-19,0.61,1018647,620374,1639021,0,0,0
2019-02-20,0.54,1142856,621668,1764524,0,0,0
2019-02-21,0.66,869622,572259,1441881,0,0,0
2019-02-22,0.63,1198875,750866,1949741,0,0,0
2019-02-25,0.55,1237274,685238,1922512,0,0,0
2019-02-26,0.6,953320,571734,1525054,0,0,0
2019-02-27,0.54,1041781,564022,1605803,0,0,0
2019-02-28,0.63,1103692,695722,1799414,0,0,0
2019-03-01,0.6,1250034,744655,1994689,0,0,0
2019-03-04,0.67,1079635,719577,1799212,0,0,0
2019-03-05,0.67,1024928,681959,1706887,0,0,0
2019-03-06,0.7,991028,697993,1689021,0,0,0
2019-03-07,0.76,940954,718836,1659790,0,0,0
2019-03-08,0.75,929767,693735,1623502,0,0,0
2019-03-11,0.57,1047523,594619,1642142,0,0,0
2019-03-12,0.66,964175,638469,1602644,0,0,0
2019-03-13,0.52,1127424,589729,1717153,0,0,0
2019-03-14,0.65,999100,649302,1648402,0,0,0
2019-03-15,0.57,1458375,826746,2285121,0,0,0
2019-03-18,0.52,1112544,576718,1689262,0,0,0
2019-03-19,0.58,1078623,620918,1699541,0,0,0
2019-03-20,0.58,1038745,604610,1643355,0,0,0
2019-03-21,0.51,1294919,658201,1953120,0,0,0
2019-03-22,0.68,1144705,775827,1920532,0,0,0
2019-03-25,0.62,901765,560325,1462090,0,0,0
2019-03-26,0.65,742805,486417,1229222,0,0,0
2019-03-27,0.69,848465,585373,1433838,0,0,0
2019-03-28,0.71,709462,501508,1210970,0,0,0
2019-03-29,0.65,936380,608984,1545364,0,0,0
2019-04-01,0.61,931739,568565,1500304,0,0,0
2019-04-02,0.57,881986,499054,1381040,0,0,0
2019-04-03,0.52,1085843,566160,1652003,0,0,0
2019-04-04,0.59,846444,496533,1342977,0,0,0
2019-04-05,0.59,1010592,597843,1608435,0,0,0
2019-04-08,0.68,846951,578942,1425893,0,0,0
2019-04-09,0.58,912676,525321,1437997,0,0,0
2019-04-10,0.62,830752,515616,1346368,0,0,0
2019-04-11,0.67,806635,536535,1343170,0,0,0
2019-04-12,0.54,1281130,688106,1969236,0,0,0
2019-04-15,0.57,869422,497774,1367196,0,0,0
2019-04-16,0.58,1095380,638821,1734201,0,0,0
2019-04-17,0.55,1268430,692802,1961232,0,0,0
2019-04-18,0.62,1201213,740227,1941440,0,0,0
2019-04-22,0.6,966506,578253,1544759,0,0,0
2019-04-23,0.59,1135704,668685,1804389,0,0,0
2019-04-24,0.6,1001346,596515,1597861,0,0,0
2019-04-25,0.57,1201612,690907,1892519,0,0,0
2019-04-26,0.63,1227766,772592,2000358,0,0,0
2019-04-29,0.61,1106508,674174,1780682,0,0,0
2019-04-30,0.65,1032818,668938,1701756,0,0,0
2019-05-01,0.63,1204723,764643,1969366,0,0,0
2019-05-02,0.64,1109963,708637,1818600,0,0,0
2019-05-03,0.52,1258967,651176,1910143,0,0,0
2019-05-06,0.63,963040,607530,1570570,0,0,0
2019-05-07,0.68,1062079,727217,1789296,0,0,0
2019-05-08,0.66,850759,558340,1409099,0,0,0
2019-05-09,0.7,1023761,716578,1740339,0,0,0
2019-05-10,0.8,1016185,815091,1831276,0,0,0
2019-05-13,0.79,965156,758814,1723970,0,0,0
2019-05-14,0.7,865620,603876,1469496,0,0,0
2019-05-15,0.77,889012,681752,1570764,0,0,0
2019-05-16,0.66,1114336,730249,1844585,0,0,0
2019-05-17,0.81,1084448,877762,1962210,0,0,0
2019-05-20,0.65,1074402,703725,1778127,0,0,0
2019-05-21,0.57,913247,518154,1431401,0,0,0
2019-05-22,0.72,841043,607282,1448325,0,0,0
2019-05-23,0.8,988866,791748,1780614,0,0,0
2019-05-24,0.76,882744,671818,1554562,0,0,0
2019-05-28,0.68,862138,588704,1450842,0,0,0
2019-05-29,0.63,979704,621859,1601563,0,0,0
2019-05-30,0.64,900243,574384,1474627,0,0,0
2019-05-31,0.83,963329,795843,1759172,0,0,0
2019-06-03,0.67,979370,659855,1639225,0,0,0
2019-06-04,0.67,999117,668182,1667299,0,0,0
2019-06-05,0.64,964134,616954,1581088,0,0,0
2019-06-06,0.66,951530,632090,1583620,0,0,0
2019-06-07,0.51,1277782,653832,1931614,0,0,0
2019-06-10,0.57,1148733,659584,1808317,0,0,0
2019-06-11,0.65,939542,614894,1554436,0,0,0
2019-06-12,0.77,807702,618660,1426362,0,0,0
2019-06-13,0.63,877774,548758,1426532,0,0,0
2019-06-14,0.63,904100,569657,1473757,0,0,0
2019-06-17,0.72,870584,626163,1496747,0,0,0
2019-06-18,0.55,1117072,617389,1734461,0,0,0
2019-06-19,0.61,897759,547291,1445050,0,0,0
2019-06-20,0.52,1148393,599359,1747752,0,0,0
2019-06-21,0.53,1208726,645304,1854030,0,0,0
2019-06-24,0.59,858390,507784,1366174,0,0,0
2019-06-25,0.63,867248,544717,1411965,0,0,0
2019-06-26,0.67,896339,599589,1495928,0,0,0
2019-06-27,0.58,880443,509219,1389662,0,0,0
2019-06-28,0.55,1054906,584246,1639152,0,0,0
2019-07-01,0.65,1019617,666750,1686367,0,0,0
2019-07-02,0.66,735974,485435,1221409,0,0,0
2019-07-03,0.64,647327,414050,1061377,0,0,0
2019-07-05,0.61,836671,508795,1345466,0,0,0
2019-07-08,0.63,840533,529644,1370177,0,0,0
2019-07-09,0.58,941111,548213,1489324,0,0,0
2019-07-10,0.51,1072189,547357,1619546,0,0,0
2019-07-11,0.61,957745,587753,1545498,0,0,0
2019-07-12,0.55,1082878,593296,1676174,0,0,0
2019-07-15,0.59,807742,473581,1281323,0,0,0
2019-07-16,0.62,876077,541638,1417715,0,0,0
2019-07-17,0.67,828522,554443,1382965,0,0,0
2019-07-18,0.6,973173,587478,1560651,0,0,0
2019-07-19,0.6,1074312,647865,1722177,0,0,0
2019-07-22,0.71,878629,624491,1503120,0,0,0
2019-07-23,0.61,990645,607726,1598371,0,0,0
2019-07-24,0.66,1033192,684552,1717744,0,0,0
2019-07-25,0.68,1015283,689682,1704965,0,0,0
2019-07-26,0.6,1117110,674953,1792063,0,0,0
2019-07-29,0.71,840877,594920,1435797,0,0,0
2019-07-30,0.73,851995,618704,1470699,0,0,0
2019-07-31,0.62,1095430,682247,1777677,0,0,0
2019-08-01,0.75,1062839,797472,1860311,0,0,0
2019-08-02,0.87,1015573,888014,1903587,0,0,0
2019-08-05,0.84,961684,812339,1774023,0,0,0
2019-08-06,0.78,860334,672164,1532498,0,0,0
2019-08-07,0.78,883268,685729,1568997,0,0,0
2019-08-08,0.62,996781,617243,1614024,0,0,0
2019-08-09,0.68,874906,594070,1468976,0,0,0
2019-08-12,0.78,767458,599239,1366697,0,0,0
2019-08-13,0.66,884175,583924,1468099,0,0,0
2019-08-14,0.84,1022609,858059,1880668,0,0,0
2019-08-15,0.98,974585,953303,1927888,0,0,0
2019-08-16,0.67,1187690,800064,1987754,0,0,0
2019-08-19,0.55,1076910,589277,1666187,0,0,0
2019-08-20,0.69,845798,587627,1433425,0,0,0
2019-08-21,0.6,939289,567470,1506759,0,0,0
2019-08-22,0.74,768310,568720,1337030,0,0,0
2019-08-23,0.88,992661,874414,1867075,0,0,0
2019-08-26,0.58,758100,439235,1197335,0,0,0
2019-08-27,0.64,844488,537569,1382057,0,0,0
2019-08-28,0.64,773692,492053,1265745,0,0,0
2019-08-29,0.66,881877,581314,1463191,0,0,0
2019-08-30,0.68,808357,551481,1359838,0,0,0
2019-09-03,0.73,694019,508049,1202068,0,0,0
2019-09-04,0.68,896626,611632,1508258,0,0,0
2019-09-05,0.53,1202776,641162,1843938,0,0,0
2019-09-06,0.56,1029754,577475,1607229,0,0,0
2019-09-09,0.59,1196821,707290,1904111,0,0,0
2019-09-10,0.65,1151728,747046,1898774,0,0,0
2019-09-11,0.54,1308692,705249,2013941,0,0,0
2019-09-12,0.55,1103457,610116,1713573,0,0,0
2019-09-13,0.62,977275,607781,1585056,0,0,0
2019-09-16,0.68,968232,658040,1626272,0,0,0
2019-09-17,0.56,851323,477486,1328809,0,0,0
2019-09-18,0.7,828372,583584,1411956,0,0,0
2019-09-19,0.67,996626,662944,1659570,0,0,0
2019-09-20,0.65,1296617,840375,2136992,0,0,0
2019-09-23,0.65,992236,640296,1632532,0,0,0
2019-09-24,0.7,1141623,802384,1944007,0,0,0
2019-09-25,0.67,903105,604220,1507325,0,0,0
2019-09-26,0.74,828076,613123,1441199,0,0,0
2019-09-27,0.72,1183999,855110,2039109,0,0,0
2019-09-30,0.67,641619,430827,1072446,0,0,0
2019-10-01,0.73,850323,616939,1467262,0,0,0
2019-10-02,0.84,794943,665991,1460934,0,0,0
2019-10-03,0.77,847645,656572,1504217,0,0,0
2019-10-04,0.65,916877,598296,1515173,0,0,0
2019-10-08,0.65,713496,466426,1179922,96709796,81619655,178329451
2019-10-09,0.59,586752,346043,932795,97929178,82801642,180730820
2019-10-10,0.58,818445,476546,1294991,98992195,83447410,182439605
2019-10-11,0.56,1197648,664707,1862355,100383877,84597094,184980971
2019-10-14,0.61,660651,404221,1064872,98981344,83338969,182320313
2019-10-15,0.55,1069358,593020,1662378,100344046,84424983,184769029
2019-10-16,0.63,936028,588366,1524394,101961943,85656630,187618573
2019-10-17,0.6,1019391,609922,1629313,103849294,87157628,191006922
2019-10-18,0.69,1227903,845661,2073564,105188677,88011286,193199963
2019-10-21,0.61,1021800,623701,1645501,87486804,74890253,162377057
2019-10-22,0.61,1072290,648920,1721210,89924833,76787823,166712656
2019-10-23,0.69,956983,660252,1617235,92169666,78611368,170781034
2019-10-24,0.68,1105727,751053,1856780,93987268,80042350,174029618
2019-10-25,0.56,1173928,661480,1835408,95709169,81549789,177258958
2019-10-28,0.51,869490,446905,1316395,93252726,79444371,172697097
2019-10-29,0.55,1108309,611743,1720052,95523546,81121520,176645066
2019-10-30,0.6,1112393,669892,1782285,97523268,82652331,180175599
2019-10-31,0.71,1138986,807905,1946891,99273387,84064340,183337727
2019-11-01,0.53,1310422,693878,2004300,100769565,85458578,186228143
2019-11-04,0.54,1478964,791284,2270248,98169331,83481767,181651098
2019-11-05,0.58,1225300,711548,1936848,100103949,85186372,185290321
2019-11-06,0.63,1110149,696600,1806749,102018264,87092537,189110801
2019-11-07,0.54,1406632,753545,2160177,103380863,88443015,191823878
2019-11-08,0.59,1234163,732151,1966314,105295145,89855672,195150817
2019-11-11,0.61,969084,590474,1559558,103228389,87912753,191141142
2019-11-12,0.59,1159301,688531,1847832,104822694,89252307,194075001
2019-11-13,0.58,1160880,668607,1829487,106444896,90327518,196772414
2019-11-14,0.47,1294073,609311,1903384,107911244,91480069,199391313
2019-11-15,0.49,1619511,792026,2411537,109528968,92539733,202068701
2019-11-18,0.55,1304347,720252,2024599,93080174,78298316,171378490
2019-11-19,0.58,1126663,652013,1778676,95588092,80116765,175704857
2019-11-20,0.64,1129461,721353,1850814,97546649,82040492,179587141
2019-11-21,0.59,998396,584335,1582731,99351455,83489997,182841452
2019-11-22,0.58,1134580,659960,1794540,101383019,85086158,186469177
2019-11-25,0.63,1005076,636312,1641388,99301981,83283752,182585733
2019-11-26,0.57,974482,554580,1529062,101301562,84982126,186283688
2019-11-27,0.58,980600,572674,1553274,102779129,86260829,189039958
2019-11-29,0.59,539757,321000,860757,104098585,87435350,191533935
2019-12-02,0.66,991546,654018,1645564,101178418,85273825,186452243
2019-12-03,0.7,1002067,704564,1706631,103180984,86802219,189983203
2019-12-04,0.54,883060,478535,1361595,104948562,88156801,193105363
2019-12-05,0.65,772662,503919,1276581,105919787,89091294,195011081
2019-12-06,0.53,1204297,642613,1846910,107511105,90385490,197896595
2019-12-09,0.64,918390,587258,1505648,105452083,88789414,194241497
2019-12-10,0.76,841591,643178,1484769,107285569,90321722,197607291
2019-12-11,0.52,1054117,552622,1606739,108722682,91531984,200254666
2019-12-12,0.45,1397487,628085,2025572,110199510,92803927,203003437
2019-12-13,0.55,1229546,679551,1909097,111909299,94364488,206273787
2019-12-16,0.61,1364895,829401,2194296,110195528,92906598,203102126
2019-12-17,0.53,1045818,552848,1598666,111434909,93694388,205129297
2019-12-18,0.49,1124873,550276,1675149,112531596,94563502,207095098
2019-12-19,0.54,1486510,796768,2283278,113741139,95651146,209392285
2019-12-20,0.46,1752106,803198,2555304,115028772,96776969,211805741
2019-12-23,0.54,1182262,640391,1822653,95370141,80200990,175571131
2019-12-24,0.52,590330,304596,894926,97464307,81840438,179304745
2019-12-26,0.43,1150283,499237,1649520,98284143,82420508,180704651
2019-12-27,0.6,1161024,698615,1859639,99560530,83457987,183018517
2019-12-30,0.59,871002,511572,1382574,97499167,81927894,179427061
2019-12-31,0.56,760197,422179,1182376,98882212,83394333,182276545
2020-01-02,0.54,1333828,725925,2059753,99729533,84509816,184239349
2020-01-03,0.55,1258190,695128,1953318,101339668,86006570,187346238
2020-01-06,0.54,1121238,603208,1724446,100298010,85053850,185351860
2020-01-07,0.44,1304013,580154,1884167,102369736,86879605,189249341
2020-01-08,0.47,1450970,682223,2133193,104331251,88322948,192654199
2020-01-09,0.49,1485671,723324,2208995,105871440,89690008,195561448
2020-01-10,0.52,1515448,792528,2307976,107770935,91552530,199323465
2020-01-13,0.47,1586946,753352,2340298,106292613,90464718,196757331
2020-01-14,0.47,1506113,705510,2211623,108327580,92032856,200360436
2020-01-15,0.44,1482957,653908,2136865,110348919,93641126,203990045
2020-01-16,0.47,1387840,652812,2040652,112136955,95047266,207184221
2020-01-17,0.48,1956611,942903,2899514,113685761,96548051,210233812
2020-01-21,0.59,1445433,858881,2304314,68671704,57458423,126130127
2020-01-22,0.52,1510924,783164,2294088,71956709,60196069,132152778
2020-01-23,0.54,1349003,730971,2079974,74493910,62390378,136884288
2020-01-24,0.7,1593003,1118847,2711850,76768639,64334473,141103112
2020-01-27,0.64,1194873,759507,1954380,74489927,63638691,138128618
2020-01-28,0.55,1210655,662198,1872853,76990448,65637195,142627643
2020-01-29,0.5,1607150,799003,2406153,79242737,67262758,146505495
2020-01-30,0.61,1303360,792137,2095497,81442707,68976163,150418870
2020-01-31,0.74,1455973,1075942,2531915,83244853,70652915,153897768
2020-02-03,0.5,1287956,648801,1936757,79699382,68426688,148126070
2020-02-04,0.46,1608168,747692,2355860,82052348,70154105,152206453
2020-02-05,0.51,1599028,808834,2407862,84584121,71740745,156324866
2020-02-06,0.47,1600255,755509,2355764,86932810,73346357,160279167
2020-02-07,0.56,1515816,847313,2363129,88670712,74891277,163561989
2020-02-10,0.46,1414307,656586,2070893,86170305,72966674,159136979
2020-02-11,0.45,1417843,641155,2058998,88711191,74727307,163438498
2020-02-12,0.48,1556161,743929,2300090,90952365,76370224,167322589
2020-02-13,0.55,1377718,751487,2129205,93256952,78032281,171289233
2020-02-14,0.58,1471438,850779,2322217,95011411,79520248,174531659
2020-02-18,0.51,1475251,751942,2227193,92355355,77730868,170086223
2020-02-19,0.45,1596570,717581,2314151,94527320,79381911,173909231
2020-02-20,0.51,1664769,856246,2521015,96682155,80886357,177568512
2020-02-21,0.73,1485491,1077519,2563010,98854089,82511292,181365381
2020-02-24,0.7,1383684,962722,2346406,80859559,68221063,149080622
2020-02-25,0.8,1267824,1015431,2283255,83718259,70691192,154409451
2020-02-26,0.65,1233708,800234,2033942,86190601,73039921,159230522
2020-02-27,0.86,1436103,1240372,2676475,88538852,74986804,163525656
2020-02-28,0.85,1304078,1112906,2416984,90914483,77243779,168158262
2020-03-02,0.76,1062051,806588,1868639,87810956,76205476,164016432
2020-03-03,0.73,1038127,752878,1791005,90284322,78151362,168435684
2020-03-04,0.64,1047554,666483,1714037,92225580,79864809,172090389
2020-03-05,0.78,1056610,824483,1881093,94279018,81267509,175546527
2020-03-06,0.89,1231631,1090743,2322374,96270525,83169746,179440271
2020-03-09,1.12,898496,1005004,1903500,93731757,81713520,175445277
2020-03-10,0.75,1005506,751210,1756716,95685024,82631600,178316624
2020-03-11,1.02,797129,816566,1613695,97649960,83944209,181594169
2020-03-12,1.28,966680,1241558,2208238,99572972,85388211,184961183
2020-03-13,1.0,1037557,1041279,2078836,100931902,85437513,186369415
2020-03-16,1.1,734341,806343,1540684,98293794,83955036,182248830
2020-03-17,0.86,900593,778287,1678880,99795264,84201560,183996824
2020-03-18,0.98,917376,902924,1820300,101477548,84723950,186201498
2020-03-19,0.88,928072,814375,1742447,103259735,84655512,187915247
2020-03-20,0.83,1028714,856564,1885278,104492289,85067357,189559646
2020-03-23,0.62,1091881,679687,1771568,78572225,68810977,147383202
2020-03-24,0.63,1227845,767514,1995359,80789979,69587130,150377109
2020-03-25,0.65,1196896,779632,1976528,82913995,71071409,153985404
2020-03-26,0.58,1296903,757741,2054644,84786714,72448674,157235388
2020-03-27,0.7,1069793,747664,1817457,86897920,73834956,160732876
2020-03-30,0.68,772450,522484,1294934,84501131,71675798,156176929
2020-03-31,0.7,707610,495840,1203450,86418076,72992393,159410469
2020-04-01,0.86,882491,755712,1638203,88027536,74066052,162093588
2020-04-02,0.82,921301,755597,1676898,89386783,74946068,164332851
2020-04-03,0.83,1046416,868724,1915140,91298061,76207863,167505924
2020-04-06,0.69,1119600,768441,1888041,89271367,74727595,163998962
2020-04-07,0.65,1263038,826899,2089937,91468218,76080955,167549173
2020-04-08,0.65,974247,631901,1606148,93200502,77591549,170792051
2020-04-09,0.65,1318239,861743,2179982,94856296,79105572,173961868
2020-04-13,0.65,940300,613884,1554184,93504452,77991731,171496183
2020-04-14,0.58,1241368,722777,1964145,95523545,79203285,174726830
2020-04-15,0.7,1152563,808354,1960917,96716880,80638157,177355037
2020-04-16,0.59,1452660,854848,2307508,99198649,82122385,181321034
2020-04-17,0.6,1443139,859503,2302642,101233067,83385419,184618486
2020-04-20,0.55,1135690,619082,1754772,81187056,68078042,149265098
2020-04-21,0.69,966862,664394,1631256,84081992,70103942,154185934
2020-04-22,0.66,1184290,782670,1966960,86083497,71799902,157883399
2020-04-23,0.59,1317322,780282,2097604,88111340,73327063,161438403
2020-04-24,0.6,1253761,755632,2009393,90211626,74910236,165121862
2020-04-27,0.58,1217755,707812,1925567,88050558,72701848,160752406
2020-04-28,0.56,1198914,674033,1872947,90768079,74491413,165259492
2020-04-29,0.53,1551615,827035,2378650,92863581,76081884,168945465
2020-04-30,0.68,1433573,976654,2410227,95291194,77837065,173128259
2020-05-01,0.82,1345701,1109042,2454743,97156251,79379259,176535510
2020-05-04,0.69,1029802,709143,1738945,94237043,77258661,171495704
2020-05-05,0.59,1307757,777282,2085039,96519840,78921640,175441480
2020-05-06,0.59,1209800,716988,1926788,98422684,80373466,178796150
2020-05-07,0.59,1402176,827188,2229364,100195755,81888352,182084107
2020-05-08,0.53,1672655,883517,2556172,102056237,83344924,185401161
2020-05-11,0.5,1312559,658319,1970878,99483818,81154675,180638493
2020-05-12,0.6,1596513,960889,2557402,102566913,82820031,185386944
2020-05-13,0.72,1524034,1094381,2618415,104599209,84387578,188986787
2020-05-14,0.64,1339181,862385,2201566,106722616,86032264,192754880
2020-05-15,0.57,1551950,881781,2433731,108689475,87229819,195919294
2020-05-18,0.47,1864906,881124,2746030,90744304,72799722,163544026
2020-05-19,0.46,1578946,726030,2304976,94683412,74827794,169511206
2020-05-20,0.49,1586269,776495,2362764,96990856,76563723,173554579
2020-05-21,0.55,1314227,725600,2039827,99796619,78436774,178233393
2020-05-22,0.57,1465629,829082,2294711,101971626,79962131,181933757
2020-05-26,0.5,1696763,841082,2537845,99554772,77772337,177327109
2020-05-27,0.51,1732666,887551,2620217,102352742,79602931,181955673
2020-05-28,0.54,1464307,795839,2260146,105037714,81439936,186477650
2020-05-29,0.58,1484547,856668,2341215,107198430,83018402,190216832
2020-06-01,0.46,1327341,609643,1936984,104389589,80675066,185064655
2020-06-02,0.47,1520343,712569,2232912,107151951,82304913,189456864
2020-06-03,0.4,2184998,870159,3055157,109580832,84092888,193673720
2020-06-04,0.43,2312443,1004308,3316751,111465203,85206293,196671496
2020-06-05,0.41,3163182,1292933,4456115,114649613,87242458,201892071
2020-06-08,0.37,2694735,1008948,3703683,113048791,85716044,198764835
2020-06-09,0.4,2208985,877844,3086829,117523825,88037386,205561211
2020-06-10,0.45,2212331,1000967,3213298,120654459,89810330,210464789
2020-06-11,0.7,2024763,1414648,3439411,123238711,91579605,214818316
2020-06-12,0.71,1684266,1188897,2873163,125699827,93741669,219441496
2020-06-15,0.51,1404677,723401,2128078,121610255,91601086,213211341
2020-06-16,0.45,1542185,689302,2231487,124252968,92999010,217251978
2020-06-17,0.51,1388305,701375,2089680,126223854,94475926,220699780
2020-06-18,0.5,1358526,673034,2031560,128019136,95656823,223675959
2020-06-19,0.57,2099228,1190640,3289868,130073548,96830132,226903680
2020-06-22,0.47,1535482,727975,2263457,99517890,72809445,172327335
2020-06-23,0.45,1476620,667847,2144467,103151349,74959499,178110848
2020-06-24,0.63,1389930,868932,2258862,106001435,76722217,182723652
2020-06-25,0.54,1346092,733383,2079475,108492396,78622430,187114826
2020-06-26,0.74,1330607,980866,2311473,111015282,80235499,191250781
2020-06-29,0.55,1222573,673231,1895804,106830234,77864375,184694609
2020-06-30,0.52,1230106,636535,1866641,109480547,79418033,188898580
2020-07-01,0.46,1282836,595224,1878060,111840109,80737302,192577411
2020-07-02,0.51,1444272,736859,2181131,113654129,81956188,195610317
2020-07-06,0.42,1562735,661398,2224133,111825677,80703319,192528996
2020-07-07,0.45,1349135,604745,1953880,114517901,82375637,196893538
2020-07-08,0.4,1511700,605084,2116784,116845516,83980607,200826123
2020-07-09,0.44,1569081,693231,2262312,119282130,85593246,204875376
2020-07-10,0.46,1646450,761454,2407904,121737844,87058102,208795946
2020-07-11,0.46,1949672,897190,2846862,128570311,90971213,219541524
2020-07-13,0.41,1898165,786583,2684748,119274528,85263323,204537851
2020-07-14,0.43,1568445,673955,2242400,122098614,87053118,209151732
2020-07-15,0.38,1867660,712875,2580535,124265104,88265589,212530693
2020-07-16,0.47,1539505,718348,2257853,126636808,89680790,216317598
2020-07-17,0.46,1949672,897190,2846862,128570311,90971213,219541524
2020-07-20,0.45,1656567,749290,2405857,102636697,73603305,176240002
2020-07-21,0.39,1581715,614108,2195823,106012387,75673814,181686201
2020-07-22,0.49,1392123,678673,2070796,109431534,77583077,187014611
2020-07-23,0.53,1724382,919600,2643982,112054460,79207489,191261949
2020-07-24,0.6,1585436,951645,2537081,114265738,80813796,195079534
2020-07-27,0.44,1397418,609037,2006455,110248912,78639602,188888514
2020-07-28,0.5,1232952,612948,1845900,113377848,80445031,193822879
2020-07-29,0.51,1449502,733982,2183484,115661893,82116846,197778739
2020-07-30,0.55,1415528,777171,2192699,118053792,83783002,201836794
2020-07-31,0.54,1822074,987915,2809989,120339077,85480294,205819371
2020-08-03,0.44,1806413,791219,2597632,116015218,83006338,199021556
2020-08-04,0.42,1752969,737924,2490893,119523116,84871269,204394385
2020-08-05,0.41,1807883,735927,2543810,122095217,86385456,208480673
2020-08-06,0.42,2005619,847565,2853184,125007824,87939814,212947638
2020-08-07,0.51,1980564,1005460,2986024,127135403,89614199,216749602
2020-08-10,0.41,1855135,760142,2615277,123802385,87262547,211064932
2020-08-11,0.45,1866161,834510,2700671,127256971,89157814,216414785
2020-08-12,0.47,1493249,694482,2187731,129504930,90755129,220260059
2020-08-13,0.46,1508303,686363,2194666,131349365,92061997,223411362
2020-08-14,0.54,1567219,853169,2420388,133629580,93560800,227190380
2020-08-17,0.49,1503746,743585,2247331,130005485,91202054,221207539
2020-08-18,0.46,1412924,645580,2058504,132733622,92844024,225577646
2020-08-19,0.43,1596186,686408,2282594,134685590,94300906,228986496
2020-08-20,0.46,1545215,709930,2255145,136981127,95772645,232753772
2020-08-24,0.42,1615047,676282,2291329,112635255,79717310,192352565
2020-08-25,0.42,1570216,659980,2230196,116752082,81865089,198617171
2020-08-26,0.39,1674314,656717,2331031,119873162,83981212,203854374
2020-08-27,0.38,1710570,642253,2352823,122600888,85793418,208394306
2020-08-28,0.42,1621990,675474,2297464,125552619,87505741,213058360
2020-08-31,0.45,1673711,758138,2431849,119803916,83582326,203386242
2020-09-01,0.4,1751527,705054,2456581,134229132,96370025,230599157
2020-09-02,0.4,1947902,778509,2726411,136851610,97989977,234841587
2020-09-03,0.58,1701818,992458,2694276,140118361,100010607,240128968
2020-09-04,0.67,1653431,1106767,2760198,142393800,101550800,243944600
2020-09-08,0.57,1433892,819453,2253345,137981130,98700316,236681446
2020-09-09,0.62,1430439,885721,2316160,141127718,100527886,241655604
2020-09-10,0.54,1334203,717554,2051757,143429120,101992391,245421511
2020-09-11,0.67,1540854,1028361,2569215,145374311,103565517,248939828
2020-09-14,0.49,1501582,740552,2242134,141537304,101396898,242934202
2020-09-15,0.46,1487029,691198,2178227,144124592,103081609,247206201
2020-09-16,0.51,1569231,795119,2364350,146233875,104616844,250850719
2020-09-17,0.58,1420548,825462,2246010,148404860,105961282,254366142
2020-09-18,0.63,1821744,1140489,2962233,150471627,107109368,257580995
2020-09-21,0.49,1484040,726180,2210220,121731613,86592100,208323713
2020-09-22,0.55,1299465,708228,2007693,124961911,88938873,213900784
2020-09-23,0.51,1434918,729176,2164094,127825741,90623669,218449410
2020-09-24,0.63,1190028,751051,1941079,130429753,92456621,222886374
2020-09-25,0.56,1270370,711460,1981830,132450391,93880918,226331309
2020-09-28,0.45,1263283,574269,1837552,127885959,91173699,219059658
2020-09-29,0.49,1144748,563700,1708448,130456077,92664840,223120917
2020-09-30,0.45,1381129,619065,2000194,132589608,94189594,226779202
2020-10-01,0.5,1447213,723672,2170885,134623908,95407311,230031219
2020-10-02,0.54,1411965,756590,2168555,136678518,96714008,233392526
2020-10-05,0.49,1293118,629220,1922338,133289247,94667350,227956597
2020-10-06,0.46,1459167,668492,2127659,136055459,96259465,232314924
2020-10-07,0.42,1329440,560885,1890325,138329119,98015333,236344452
2020-10-08,0.39,1578128,610765,2188893,140326927,99353318,239680245
2020-10-09,0.44,1650867,732517,2383384,142676045,100521871,243197916
2020-10-12,0.41,1801751,730382,2532133,139803728,98522634,238326362
2020-10-13,0.39,1712932,665755,2378687,142233741,99959915,242193656
2020-10-14,0.47,1680441,795529,2475970,144909434,101625331,246534765
2020-10-15,0.46,1558729,710735,2269464,147366796,103267757,250634553
2020-10-16,0.45,1962712,889320,2852032,149567929,104580336,254148265
2020-10-19,0.43,1648791,712233,2361024,123364014,87212322,210576336
2020-10-20,0.52,1316747,682978,1999725,127342103,89685785,217027888
2020-10-21,0.5,1456999,735167,2192166,130150460,91448835,221599295
2020-10-22,0.48,1565142,745352,2310494,132869273,93316417,226185690
2020-10-23,0.53,1564801,823766,2388567,135392454,94812054,230204508
2020-10-26,0.59,1224489,724081,1948570,131064458,92235026,223299484
2020-10-27,0.48,1209805,574774,1784579,133921990,94393122,228315112
2020-10-28,0.65,1351705,874810,2226515,136728517,96229734,232958251
2020-10-29,0.52,1506442,779432,2285874,139340054,98024639,237364693
2020-10-30,0.77,1479891,1139299,2619190,141603888,99384285,240988173
2020-11-02,0.62,1187827,734931,1922758,134649558,95735986,230385544
2020-11-03,0.45,1241884,557795,1799679,137961214,97647724,235608938
2020-11-04,0.45,1397512,632053,2029565,140394473,99068470,239462943
2020-11-05,0.44,1690016,749007,2439023,142446473,100571590,243018063
2020-11-06,0.41,1870116,766714,2636830,144656983,102143860,246800843
2020-11-09,0.37,2513227,934564,3447791,141795459,99767711,241563170
2020-11-10,0.52,1717155,885642,2602797,145472250,102103845,247576095
2020-11-11,0.46,1432240,657386,2089626,148316646,103953602,252270248
2020-11-12,0.52,1592439,835732,2428171,150428645,105661063,256089708
2020-11-13,0.5,1838009,925101,2763110,152702228,107631819,260334047
2020-11-16,0.43,2070316,885684,2956000,149353098,105191905,254545003
2020-11-17,0.49,1647214,807519,2454733,150311296,106362758,256674054
2020-11-19,0.46,1880094,859335,2739429,157288528,111298589,268587117
2020-11-20,0.4,2230348,892171,3122519,159715264,113183884,272899148
2020-11-24,0.38,2530281,969887,3500168,139153499,97761288,236914787
2020-11-25,0.4,1924753,774904,2699657,143355365,100530973,243886338
2020-11-27,0.41,1481409,604464,2085873,146428719,102680915,249109634
2020-12-01,0.37,2108978,778007,2886985,146740023,102469788,249209811
2020-12-02,0.4,1975232,799956,2775188,150543039,104529359,255072398
2020-12-03,0.35,2071470,722446,2793916,153732282,106447663,260179945
2020-12-04,0.39,2327743,913902,3241645,156795732,108414858,265210590
2020-12-07,0.37,2007251,734811,2742062,153442192,105911452,259353644
2020-12-08,0.38,1877822,715323,2593145,157356877,108298279,265655156
2020-12-09,0.42,1960700,828555,2789255,161555875,110076879,271632754
2020-12-10,0.4,1626457,656533,2282990,163219495,111915057,275134552
2020-12-11,0.5,1734103,865345,2599448,165818870,113584862,279403732
