,PCRatio,VolumeCall,VolumePut,VolumeTotal,OpenInterestCall,OpenInterestPut,OpenInterestTotal
2006-11-01,2.18,127253,277066,404319,0,0,0
2006-11-02,3.41,103756,353403,457159,0,0,0
2006-11-03,2.18,146876,319521,466397,0,0,0
2006-11-06,1.57,117877,184812,302689,0,0,0
2006-11-07,2.18,115280,251486,366766,0,0,0
2006-11-08,1.07,183995,196163,380158,0,0,0
2006-11-09,2.25,123483,277338,400821,0,0,0
2006-11-10,2.62,95349,249492,344841,0,0,0
2006-11-13,1.13,182175,205215,387390,0,0,0
2006-11-14,1.0,293184,293075,586259,0,0,0
2006-11-15,1.22,364530,445573,810103,0,0,0
2006-11-16,1.75,251519,438931,690450,0,0,0
2006-11-17,1.85,200827,371000,571827,0,0,0
2006-11-20,2.38,113439,269830,383269,0,0,0
2006-11-21,1.36,133853,181772,315625,0,0,0
2006-11-22,1.72,71512,122870,194382,0,0,0
2006-11-24,3.39,60145,203796,263941,0,0,0
2006-11-27,3.36,160744,540236,700980,0,0,0
2006-11-28,1.74,186818,324431,511249,0,0,0
2006-11-29,0.7,371908,260135,632043,0,0,0
2006-11-30,1.96,137882,270153,408035,0,0,0
2006-12-01,1.63,255094,414996,670090,0,0,0
2006-12-04,1.27,187014,237058,424072,0,0,0
2006-12-05,1.44,143606,207075,350681,0,0,0
2006-12-06,2.79,116974,325844,442818,0,0,0
2006-12-07,1.3,182070,236739,418809,0,0,0
2006-12-08,1.96,119445,233673,353118,0,0,0
2006-12-11,1.68,77602,130206,207808,0,0,0
2006-12-12,1.32,200125,263711,463836,0,0,0
2006-12-13,1.76,155587,273799,429386,0,0,0
2006-12-14,0.82,427532,349170,776702,0,0,0
2006-12-15,2.13,167287,356032,523319,0,0,0
2006-12-18,2.27,130274,295696,425970,0,0,0
2006-12-19,1.51,243735,367159,610894,0,0,0
2006-12-20,1.15,119011,136542,255553,0,0,0
2006-12-21,1.48,272562,403032,675594,0,0,0
2006-12-22,1.94,123065,239041,362106,0,0,0
2006-12-26,1.61,83301,134007,217308,0,0,0
2006-12-27,1.5,126612,189709,316321,0,0,0
2006-12-28,1.83,143464,262605,406069,0,0,0
2006-12-29,2.82,93881,264532,358413,0,0,0
2007-01-03,1.79,225126,402846,627972,0,0,0
2007-01-04,2.47,174084,429189,603273,0,0,0
2007-01-05,2.88,131263,377625,508888,0,0,0
2007-01-08,1.3,158269,205060,363329,0,0,0
2007-01-09,1.05,213026,224081,437107,0,0,0
2007-01-10,1.5,267035,399245,666280,0,0,0
2007-01-11,0.91,351742,320288,672030,0,0,0
2007-01-12,1.16,257024,298596,555620,0,0,0
2007-01-16,2.51,184764,463729,648493,0,0,0
2007-01-17,2.29,134093,307227,441320,0,0,0
2007-01-18,1.68,285495,479995,765490,0,0,0
2007-01-19,1.36,279316,379746,659062,0,0,0
2007-01-22,2.02,160187,324286,484473,0,0,0
2007-01-23,1.9,150548,286565,437113,0,0,0
2007-01-24,1.65,118369,195288,313657,0,0,0
2007-01-25,2.63,153015,402103,555118,0,0,0
2007-01-26,2.39,117144,279600,396744,0,0,0
2007-01-29,1.89,158438,299345,457783,0,0,0
2007-01-30,1.47,126457,185839,312296,0,0,0
2007-01-31,1.34,152201,203968,356169,0,0,0
2007-02-01,2.21,117418,259723,377141,0,0,0
2007-02-02,2.37,115620,273685,389305,0,0,0
2007-02-05,1.71,116069,198123,314192,0,0,0
2007-02-06,2.24,122240,273932,396172,0,0,0
2007-02-07,1.94,136965,265302,402267,0,0,0
2007-02-08,2.52,111033,280318,391351,0,0,0
2007-02-09,1.85,221203,410252,631455,0,0,0
2007-02-12,2.21,225260,497816,723076,0,0,0
2007-02-13,1.78,192046,341097,533143,0,0,0
2007-02-14,1.6,417677,667214,1084891,0,0,0
2007-02-15,1.31,268984,353019,622003,0,0,0
2007-02-16,1.36,147793,201450,349243,0,0,0
2007-02-20,1.51,177514,267223,444737,0,0,0
2007-02-21,3.02,110079,332465,442544,0,0,0
2007-02-22,1.71,224169,383396,607565,0,0,0
2007-02-23,5.08,102746,522139,624885,0,0,0
2007-02-26,1.99,157802,314215,472017,0,0,0
2007-02-27,4.4,441281,1943695,2384976,0,0,0
2007-02-28,1.65,474011,780387,1254398,0,0,0
2007-03-01,2.36,385290,910258,1295548,0,0,0
2007-03-02,2.56,330615,847110,1177725,0,0,0
2007-03-05,3.07,341525,1047828,1389353,0,0,0
2007-03-06,2.33,303133,707203,1010336,0,0,0
2007-03-07,2.21,215715,477767,693482,0,0,0
2007-03-08,2.55,221656,564494,786150,0,0,0
2007-03-09,2.2,258183,567631,825814,0,0,0
2007-03-12,2.77,162671,450935,613606,0,0,0
2007-03-13,2.68,318058,853607,1171665,0,0,0
2007-03-14,2.18,469247,1023964,1493211,0,0,0
2007-03-15,1.84,367746,676075,1043821,0,0,0
2007-03-16,2.75,234526,643885,878411,0,0,0
2007-03-19,1.62,222467,360056,582523,0,0,0
2007-03-20,1.31,245562,320720,566282,0,0,0
2007-03-21,2.56,358630,919884,1278514,0,0,0
2007-03-22,1.31,358721,471056,829777,0,0,0
2007-03-23,2.44,143248,348865,492113,0,0,0
2007-03-26,1.83,190699,348323,539022,0,0,0
2007-03-27,2.45,122624,300351,422975,0,0,0
2007-03-28,2.28,255414,581243,836657,0,0,0
2007-03-29,2.39,190464,454332,644796,0,0,0
2007-03-30,3.05,191466,583237,774703,0,0,0
2007-04-02,1.51,197189,296804,493993,0,0,0
2007-04-03,2.78,184564,512292,696856,0,0,0
2007-04-04,2.54,138654,352129,490783,0,0,0
2007-04-05,1.24,267338,330923,598261,0,0,0
2007-04-09,1.21,166904,201201,368105,0,0,0
2007-04-10,4.67,102416,477813,580229,0,0,0
2007-04-11,2.11,213617,450013,663630,0,0,0
2007-04-12,2.67,148823,397532,546355,0,0,0
2007-04-13,2.72,115523,314124,429647,0,0,0
2007-04-16,2.01,296999,596262,893261,0,0,0
2007-04-17,1.36,268280,365576,633856,0,0,0
2007-04-18,1.3,259388,338100,597488,0,0,0
2007-04-19,2.2,230310,507428,737738,0,0,0
2007-04-20,1.2,423558,508976,932534,0,0,0
2007-04-23,1.62,222293,360043,582336,0,0,0
2007-04-24,2.36,202930,478794,681724,0,0,0
2007-04-25,1.41,282798,399544,682342,0,0,0
2007-04-26,1.83,165126,302773,467899,0,0,0
2007-04-27,3.77,116684,440290,556974,0,0,0
2007-04-30,3.9,129627,506041,635668,0,0,0
2007-05-01,2.19,277484,607468,884952,0,0,0
2007-05-02,2.37,150299,356039,506338,0,0,0
2007-05-03,3.16,99201,313926,413127,0,0,0
2007-05-04,2.26,153901,348442,502343,0,0,0
2007-05-07,3.81,80343,306190,386533,0,0,0
2007-05-08,3.44,150306,517018,667324,0,0,0
2007-05-09,3.33,133618,445357,578975,0,0,0
2007-05-10,2.65,226484,599714,826198,0,0,0
2007-05-11,1.65,233418,385568,618986,0,0,0
2007-05-14,1.83,397518,727025,1124543,0,0,0
2007-05-15,1.94,343310,666074,1009384,0,0,0
2007-05-16,1.94,265607,514639,780246,0,0,0
2007-05-17,1.24,306354,378620,684974,0,0,0
2007-05-18,2.55,261611,666086,927697,0,0,0
2007-05-21,2.04,242735,494160,736895,0,0,0
2007-05-22,4.23,143815,608110,751925,0,0,0
2007-05-23,2.38,174832,416611,591443,0,0,0
2007-05-24,2.35,257169,603260,860429,0,0,0
2007-05-25,3.36,137263,461802,599065,0,0,0
2007-05-29,1.87,128969,240885,369854,0,0,0
2007-05-30,2.35,182117,428060,610177,0,0,0
2007-05-31,2.49,245402,610974,856376,0,0,0
2007-06-01,1.93,252360,486920,739280,0,0,0
2007-06-04,2.34,132367,309855,442222,0,0,0
2007-06-05,1.58,342045,539967,882012,0,0,0
2007-06-06,3.17,198431,628583,827014,0,0,0
2007-06-07,3.28,301495,990155,1291650,0,0,0
2007-06-08,3.22,228678,737244,965922,0,0,0
2007-06-11,2.73,203454,555102,758556,0,0,0
2007-06-12,2.74,290213,794302,1084515,0,0,0
2007-06-13,1.96,327996,642244,970240,0,0,0
2007-06-14,0.91,596831,544837,1141668,0,0,0
2007-06-15,2.49,354991,883220,1238211,0,0,0
2007-06-18,1.71,209143,357394,566537,0,0,0
2007-06-19,1.2,137767,165206,302973,0,0,0
2007-06-20,2.09,258818,540910,799728,0,0,0
2007-06-21,1.99,218910,434705,653615,0,0,0
2007-06-22,2.14,261040,557902,818942,0,0,0
2007-06-25,2.04,232888,474429,707317,0,0,0
2007-06-26,2.52,151924,383333,535257,0,0,0
2007-06-27,0.79,777087,617018,1394105,0,0,0
2007-06-28,1.55,271834,420775,692609,0,0,0
2007-06-29,2.74,231194,633025,864219,0,0,0
2007-07-02,2.36,110584,260819,371403,0,0,0
2007-07-03,3.41,77198,263016,340214,0,0,0
2007-07-05,2.87,116816,335488,452304,0,0,0
2007-07-06,3.05,152988,466752,619740,0,0,0
2007-07-09,2.01,132428,266144,398572,0,0,0
2007-07-10,1.86,328163,611870,940033,0,0,0
2007-07-11,2.2,254625,560408,815033,0,0,0
2007-07-12,1.92,266874,513622,780496,0,0,0
2007-07-13,3.22,189545,610635,800180,0,0,0
2007-07-16,1.8,251609,452457,704066,0,0,0
2007-07-17,1.82,230084,419727,649811,0,0,0
2007-07-18,2.1,268449,563403,831852,0,0,0
2007-07-19,2.57,229539,590342,819881,0,0,0
2007-07-20,2.69,546214,1470327,2016541,0,0,0
2007-07-23,1.84,182676,336773,519449,0,0,0
2007-07-24,3.2,358193,1146894,1505087,0,0,0
2007-07-25,2.05,370468,760068,1130536,0,0,0
2007-07-26,3.04,496291,1506406,2002697,0,0,0
2007-07-27,2.91,398647,1159360,1558007,0,0,0
2007-07-30,2.43,424792,1032620,1457412,0,0,0
2007-07-31,2.96,388844,1151938,1540782,0,0,0
2007-08-01,2.64,430309,1135233,1565542,0,0,0
2007-08-02,2.39,281804,672438,954242,0,0,0
2007-08-03,3.95,350424,1385578,1736002,0,0,0
2007-08-06,2.64,433634,1144365,1577999,0,0,0
2007-08-07,2.15,421239,904513,1325752,0,0,0
2007-08-08,2.38,499401,1190396,1689797,0,0,0
2007-08-09,2.7,367743,992358,1360101,0,0,0
2007-08-10,2.67,424152,1133864,1558016,0,0,0
2007-08-13,1.85,453916,840696,1294612,0,0,0
2007-08-14,1.82,448459,815420,1263879,0,0,0
2007-08-15,2.06,626868,1291760,1918628,0,0,0
2007-08-16,2.38,795908,1891884,2687792,0,0,0
2007-08-17,2.22,764945,1696587,2461532,0,0,0
2007-08-20,1.42,298541,425290,723831,0,0,0
2007-08-21,1.4,277032,387554,664586,0,0,0
2007-08-22,2.21,212004,467579,679583,0,0,0
2007-08-23,2.62,218421,572312,790733,0,0,0
2007-08-24,2.17,282489,611902,894391,0,0,0
2007-08-27,1.51,230672,348372,579044,0,0,0
2007-08-28,2.08,319765,665617,985382,0,0,0
2007-08-29,1.93,230533,445299,675832,0,0,0
2007-08-30,1.49,198037,294197,492234,0,0,0
2007-08-31,1.9,183477,349073,532550,0,0,0
2007-09-04,1.84,248377,457857,706234,0,0,0
2007-09-05,2.5,213440,533552,746992,0,0,0
2007-09-06,1.08,240634,259553,500187,0,0,0
2007-09-07,1.76,342442,603848,946290,0,0,0
2007-09-10,2.32,251530,583220,834750,0,0,0
2007-09-11,1.45,264356,384417,648773,0,0,0
2007-09-12,1.62,217501,353170,570671,0,0,0
2007-09-13,2.1,221375,464623,685998,0,0,0
2007-09-14,2.97,153194,454869,608063,0,0,0
2007-09-17,2.51,224715,565032,789747,0,0,0
2007-09-18,2.1,402640,844916,1247556,0,0,0
2007-09-19,1.62,481076,779508,1260584,0,0,0
2007-09-20,2.15,426128,916254,1342382,0,0,0
2007-09-21,1.66,379152,630924,1010076,0,0,0
2007-09-24,0.92,404073,370223,774296,0,0,0
2007-09-25,2.14,201125,430468,631593,0,0,0
2007-09-26,1.53,278974,425613,704587,0,0,0
2007-09-27,1.51,219703,332623,552326,0,0,0
2007-09-28,1.68,324151,545921,870072,0,0,0
2007-10-01,1.45,296657,431002,727659,0,0,0
2007-10-02,1.38,247435,341135,588570,0,0,0
2007-10-03,1.53,203274,310553,513827,0,0,0
2007-10-04,1.78,170405,303732,474137,0,0,0
2007-10-05,1.38,349359,481672,831031,0,0,0
2007-10-08,2.28,120645,275397,396042,0,0,0
2007-10-09,1.55,190067,294634,484701,0,0,0
2007-10-10,1.66,230630,381829,612459,0,0,0
2007-10-11,1.98,324943,644045,968988,0,0,0
2007-10-12,1.96,189276,370778,560054,0,0,0
2007-10-15,1.46,327550,477579,805129,0,0,0
2007-10-16,1.79,216433,387382,603815,0,0,0
2007-10-17,1.41,388181,547912,936093,0,0,0
2007-10-18,1.59,288764,458351,747115,0,0,0
2007-10-19,2.19,523014,1145511,1668525,0,0,0
2007-10-22,1.73,325060,560887,885947,0,0,0
2007-10-23,2.41,211527,508788,720315,0,0,0
2007-10-24,1.69,455054,769909,1224963,0,0,0
2007-10-25,2.15,243944,523967,767911,0,0,0
2007-10-26,1.84,291611,535522,827133,0,0,0
2007-10-29,1.66,207334,344392,551726,0,0,0
2007-10-30,2.7,166958,450143,617101,0,0,0
2007-10-31,1.77,338224,598063,936287,0,0,0
2007-11-01,1.98,350693,693572,1044265,0,0,0
2007-11-02,2.69,378657,1020027,1398684,0,0,0
2007-11-05,1.74,434170,754486,1188656,0,0,0
2007-11-06,1.7,522895,887081,1409976,0,0,0
2007-11-07,2.01,437575,880550,1318125,0,0,0
2007-11-08,2.38,617027,1469741,2086768,0,0,0
2007-11-09,1.91,459419,876049,1335468,0,0,0
2007-11-12,1.74,557887,973206,1531093,0,0,0
2007-11-13,1.77,545604,968401,1514005,0,0,0
2007-11-14,1.58,436883,689790,1126673,0,0,0
2007-11-15,2.27,506401,1149879,1656280,0,0,0
2007-11-16,2.11,473079,998760,1471839,0,0,0
2007-11-19,2.5,257868,645211,903079,0,0,0
2007-11-20,1.97,362269,712058,1074327,0,0,0
2007-11-21,1.59,388386,616408,1004794,0,0,0
2007-11-23,1.49,109880,163229,273109,0,0,0
2007-11-26,1.61,311546,501519,813065,0,0,0
2007-11-27,1.83,296758,542834,839592,0,0,0
2007-11-28,1.83,354184,646577,1000761,0,0,0
2007-11-29,1.63,234262,382010,616272,0,0,0
2007-11-30,1.53,288326,440408,728734,0,0,0
2007-12-03,1.28,170313,218088,388401,0,0,0
2007-12-04,1.95,193313,376491,569804,0,0,0
2007-12-05,1.38,258478,357502,615980,0,0,0
2007-12-06,1.63,292973,477767,770740,0,0,0
2007-12-07,1.66,250005,415451,665456,0,0,0
2007-12-10,1.64,308974,507902,816876,0,0,0
2007-12-11,1.71,531166,907048,1438214,0,0,0
2007-12-12,1.95,370296,720751,1091047,0,0,0
2007-12-13,1.72,363360,623878,987238,0,0,0
2007-12-14,2.27,269920,612947,882867,0,0,0
2007-12-17,2.25,383631,864167,1247798,0,0,0
2007-12-18,1.35,567907,768514,1336421,0,0,0
2007-12-19,1.8,406970,733076,1140046,0,0,0
2007-12-20,1.04,780051,814414,1594465,0,0,0
2007-12-21,0.36,2196422,799859,2996281,0,0,0
2007-12-24,1.48,164393,243198,407591,0,0,0
2007-12-26,1.19,369162,437593,806755,0,0,0
2007-12-27,1.76,240163,423217,663380,0,0,0
2007-12-28,2.33,203068,473318,676386,0,0,0
2007-12-31,1.87,248796,464156,712952,0,0,0
2008-01-02,1.68,400381,673369,1073750,0,0,0
2008-01-03,1.41,411540,580160,991700,0,0,0
2008-01-04,1.94,691782,1342767,2034549,0,0,0
2008-01-07,1.4,500071,698637,1198708,0,0,0
2008-01-08,2.95,468698,1384497,1853195,0,0,0
2008-01-09,2.15,572580,1230342,1802922,0,0,0
2008-01-10,1.68,540235,908327,1448562,0,0,0
2008-01-11,1.25,544984,682712,1227696,0,0,0
2008-01-14,1.56,478091,745608,1223699,0,0,0
2008-01-15,1.54,573244,883750,1456994,0,0,0
2008-01-16,1.74,743580,1292209,2035789,0,0,0
2008-01-17,2.07,789529,1632680,2422209,0,0,0
2008-01-18,2.2,696594,1529926,2226520,0,0,0
2008-01-22,2.08,525955,1095371,1621326,0,0,0
2008-01-23,1.94,793306,1538963,2332269,0,0,0
2008-01-24,1.33,600835,797594,1398429,0,0,0
2008-01-25,1.92,415875,799283,1215158,0,0,0
2008-01-28,1.34,333919,448322,782241,0,0,0
2008-01-29,1.38,384711,531016,915727,0,0,0
2008-01-30,1.25,604554,755061,1359615,0,0,0
2008-01-31,1.48,549382,811472,1360854,0,0,0
2008-02-01,1.16,657845,761162,1419007,0,0,0
2008-02-04,1.48,338855,502250,841105,0,0,0
2008-02-05,1.44,466378,672427,1138805,0,0,0
2008-02-06,1.34,428902,573256,1002158,0,0,0
2008-02-07,1.52,586142,889434,1475576,0,0,0
2008-02-08,1.95,361701,705359,1067060,0,0,0
2008-02-11,1.79,338270,605847,944117,0,0,0
2008-02-12,2.06,502315,1036366,1538681,0,0,0
2008-02-13,1.36,436836,596138,1032974,0,0,0
2008-02-14,1.69,459466,777704,1237170,0,0,0
2008-02-15,2.04,477195,973872,1451067,0,0,0
2008-02-19,1.5,359596,541187,900783,0,0,0
2008-02-20,1.21,380350,459835,840185,0,0,0
2008-02-21,1.9,263249,499531,762780,0,0,0
2008-02-22,1.92,302782,582799,885581,0,0,0
2008-02-25,1.24,356570,443151,799721,0,0,0
2008-02-26,1.74,380419,661535,1041954,0,0,0
2008-02-27,1.7,294474,499820,794294,0,0,0
2008-02-28,1.95,292808,570199,863007,0,0,0
2008-02-29,1.89,507977,957969,1465946,0,0,0
2008-03-03,2.39,274197,656346,930543,0,0,0
2008-03-04,1.62,463763,750645,1214408,0,0,0
2008-03-05,2.43,349865,848752,1198617,0,0,0
2008-03-06,1.61,437032,704331,1141363,0,0,0
2008-03-07,1.94,555903,1080543,1636446,0,0,0
2008-03-10,2.8,400689,1121229,1521918,0,0,0
2008-03-11,1.38,677035,932458,1609493,0,0,0
2008-03-12,1.33,453066,600872,1053938,0,0,0
2008-03-13,1.8,609943,1100151,1710094,0,0,0
2008-03-14,2.0,708193,1413280,2121473,0,0,0
2008-03-17,1.89,786554,1483681,2270235,0,0,0
2008-03-18,1.42,725211,1030514,1755725,0,0,0
2008-03-19,1.57,800511,1254636,2055147,0,0,0
2008-03-20,1.74,643544,1121103,1764647,0,0,0
2008-03-24,0.97,633566,616476,1250042,0,0,0
2008-03-25,1.28,331868,425341,757209,0,0,0
2008-03-26,1.47,440583,646187,1086770,0,0,0
2008-03-27,1.59,346693,552065,898758,0,0,0
2008-03-28,1.79,235482,421006,656488,0,0,0
2008-03-31,1.12,348459,390521,738980,0,0,0
2008-04-01,0.94,709766,663997,1373763,0,0,0
2008-04-02,1.28,414454,530036,944490,0,0,0
2008-04-03,1.33,296058,393157,689215,0,0,0
2008-04-04,1.2,422619,508593,931212,0,0,0
2008-04-07,1.16,379006,439655,818661,0,0,0
2008-04-08,1.41,232242,326951,559193,0,0,0
2008-04-09,1.46,351301,511189,862490,0,0,0
2008-04-10,1.62,291539,473556,765095,0,0,0
2008-04-11,2.49,341478,850146,1191624,0,0,0
2008-04-14,1.25,400527,499010,899537,0,0,0
2008-04-15,1.26,349268,440361,789629,0,0,0
2008-04-16,1.24,542897,674627,1217524,0,0,0
2008-04-17,1.2,429863,516379,946242,0,0,0
2008-04-18,1.22,799911,978140,1778051,0,0,0
2008-04-21,1.81,260349,470898,731247,0,0,0
2008-04-22,2.56,258712,662639,921351,0,0,0
2008-04-23,1.49,267236,397924,665160,0,0,0
2008-04-24,1.55,441269,684883,1126152,0,0,0
2008-04-25,1.48,269884,399402,669286,0,0,0
2008-04-28,1.59,266027,421909,687936,0,0,0
2008-04-29,1.93,219499,423958,643457,0,0,0
2008-04-30,1.39,328350,455586,783936,0,0,0
2008-05-01,2.1,399828,840286,1240114,0,0,0
2008-05-02,1.5,384719,576226,960945,0,0,0
2008-05-05,1.64,238971,392408,631379,0,0,0
2008-05-06,1.36,440926,598092,1039018,0,0,0
2008-05-07,1.88,382345,720209,1102554,0,0,0
2008-05-08,1.81,254656,461312,715968,0,0,0
2008-05-09,1.17,421964,493093,915057,0,0,0
2008-05-12,1.48,315492,468315,783807,0,0,0
2008-05-13,1.4,346852,486997,833849,0,0,0
2008-05-14,1.12,498008,559330,1057338,0,0,0
2008-05-15,1.17,427129,499781,926910,0,0,0
2008-05-16,1.56,551315,861215,1412530,0,0,0
2008-05-19,1.73,378504,656190,1034694,0,0,0
2008-05-20,1.99,371221,739180,1110401,0,0,0
2008-05-21,1.82,393326,717160,1110486,0,0,0
2008-05-22,2.05,309390,635753,945143,0,0,0
2008-05-23,1.79,392792,704844,1097636,0,0,0
2008-05-27,1.89,276574,521682,798256,0,0,0
2008-05-28,1.32,250159,329804,579963,0,0,0
2008-05-29,1.39,406014,562686,968700,0,0,0
2008-05-30,1.43,238119,340721,578840,0,0,0
2008-06-02,1.83,363897,665316,1029213,0,0,0
2008-06-03,2.22,381629,848821,1230450,0,0,0
2008-06-04,2.17,325390,707380,1032770,0,0,0
2008-06-05,2.0,439277,876924,1316201,0,0,0
2008-06-06,1.7,681863,1158165,1840028,0,0,0
2008-06-09,1.3,642428,833019,1475447,0,0,0
2008-06-10,1.34,496797,666619,1163416,0,0,0
2008-06-11,1.77,580494,1028584,1609078,0,0,0
2008-06-12,1.53,520358,796012,1316370,0,0,0
2008-06-13,1.18,507663,597348,1105011,0,0,0
2008-06-16,1.22,542893,661628,1204521,0,0,0
2008-06-17,1.64,318304,522771,841075,0,0,0
2008-06-18,1.4,550086,771725,1321811,0,0,0
2008-06-19,1.43,695829,992746,1688575,0,0,0
2008-06-20,2.08,667644,1386418,2054062,0,0,0
2008-06-23,1.35,419278,568033,987311,0,0,0
2008-06-24,1.55,435191,674791,1109982,0,0,0
2008-06-25,1.04,599727,623710,1223437,0,0,0
2008-06-26,1.89,602042,1135493,1737535,0,0,0
2008-06-27,1.72,521013,897244,1418257,0,0,0
2008-06-30,1.69,637805,1076269,1714074,0,0,0
2008-07-01,1.3,825326,1076418,1901744,0,0,0
2008-07-02,1.83,578601,1058545,1637146,0,0,0
2008-07-03,1.87,361120,674204,1035324,0,0,0
2008-07-07,2.01,619226,1242614,1861840,0,0,0
2008-07-08,1.76,622416,1094948,1717364,0,0,0
2008-07-09,1.29,634897,820693,1455590,0,0,0
2008-07-10,1.27,698416,885673,1584089,0,0,0
2008-07-11,1.58,885129,1395761,2280890,0,0,0
2008-07-14,1.71,676977,1154726,1831703,0,0,0
2008-07-15,1.44,1047418,1510465,2557883,0,0,0
2008-07-16,1.0,962666,958079,1920745,0,0,0
2008-07-17,1.05,1110740,1169310,2280050,0,0,0
2008-07-18,1.22,723371,880345,1603716,0,0,0
2008-07-21,1.19,418106,497570,915676,0,0,0
2008-07-22,1.07,658988,703941,1362929,0,0,0
2008-07-23,1.48,761690,1125579,1887269,0,0,0
2008-07-24,1.43,567830,810449,1378279,0,0,0
2008-07-25,0.98,517519,507842,1025361,0,0,0
2008-07-28,1.6,353913,566325,920238,0,0,0
2008-07-29,1.09,550966,603243,1154209,0,0,0
2008-07-30,1.11,575606,637079,1212685,0,0,0
2008-07-31,1.2,414478,495544,910022,0,0,0
2008-08-01,1.1,449675,496669,946344,0,0,0
2008-08-04,1.21,522872,632433,1155305,0,0,0
2008-08-05,0.91,639535,585090,1224625,0,0,0
2008-08-06,1.04,641064,668605,1309669,0,0,0
2008-08-07,1.31,424503,558188,982691,0,0,0
2008-08-08,1.48,545252,808695,1353947,0,0,0
2008-08-11,1.11,745509,825210,1570719,0,0,0
2008-08-12,1.59,556783,886762,1443545,0,0,0
2008-08-13,1.28,715009,918276,1633285,0,0,0
2008-08-14,0.86,958230,821782,1780012,0,0,0
2008-08-15,1.6,669411,1069339,1738750,0,0,0
2008-08-18,1.51,425043,642340,1067383,0,0,0
2008-08-19,1.24,576347,717054,1293401,0,0,0
2008-08-20,1.21,464606,560596,1025202,0,0,0
2008-08-21,1.72,410093,705169,1115262,0,0,0
2008-08-22,1.33,292983,391008,683991,0,0,0
2008-08-25,1.61,346063,555455,901518,0,0,0
2008-08-26,1.19,287738,342504,630242,0,0,0
2008-08-27,1.1,341360,374152,715512,0,0,0
2008-08-28,0.93,401163,374544,775707,0,0,0
2008-08-29,1.2,442222,531207,973429,0,0,0
2008-09-02,1.42,442295,629471,1071766,0,0,0
2008-09-03,0.9,757509,684654,1442163,0,0,0
2008-09-04,1.53,796315,1218602,2014917,0,0,0
2008-09-05,1.48,690124,1019464,1709588,0,0,0
2008-09-08,1.09,860604,937757,1798361,0,0,0
2008-09-09,1.48,750998,1111075,1862073,0,0,0
2008-09-10,1.54,560458,863854,1424312,0,0,0
2008-09-11,1.33,877570,1166380,2043950,0,0,0
2008-09-12,1.29,730350,940911,1671261,0,0,0
2008-09-15,1.96,784073,1537865,2321938,0,0,0
2008-09-16,1.63,1004711,1635566,2640277,0,0,0
2008-09-17,1.73,1233433,2129248,3362681,0,0,0
2008-09-18,1.44,1310916,1891156,3202072,0,0,0
2008-09-19,1.24,1279094,1581833,2860927,0,0,0
2008-09-22,1.28,561822,720847,1282669,0,0,0
2008-09-23,1.54,633634,975865,1609499,0,0,0
2008-09-24,1.65,506419,837926,1344345,0,0,0
2008-09-25,0.84,818548,690186,1508734,0,0,0
2008-09-26,1.3,521635,677884,1199519,0,0,0
2008-09-29,2.18,632316,1379123,2011439,0,0,0
2008-09-30,2.01,513591,1033114,1546705,0,0,0
2008-10-01,1.23,499804,614855,1114659,0,0,0
2008-10-02,2.17,573693,1247520,1821213,0,0,0
2008-10-03,1.64,735065,1203680,1938745,0,0,0
2008-10-06,2.06,924613,1905764,2830377,0,0,0
2008-10-07,1.07,1113454,1196448,2309902,0,0,0
2008-10-08,1.25,961420,1198324,2159744,0,0,0
2008-10-09,1.61,882385,1422736,2305121,0,0,0
2008-10-10,1.37,1177955,1618374,2796329,0,0,0
2008-10-13,1.18,792163,936067,1728230,0,0,0
2008-10-14,0.92,864659,799305,1663964,0,0,0
2008-10-15,1.2,796738,952824,1749562,0,0,0
2008-10-16,1.41,1002444,1414934,2417378,0,0,0
2008-10-17,1.14,921657,1049987,1971644,0,0,0
2008-10-20,1.03,484383,500771,985154,0,0,0
2008-10-21,1.19,458787,547627,1006414,0,0,0
2008-10-22,1.33,642494,853931,1496425,0,0,0
2008-10-23,1.54,659545,1018705,1678250,0,0,0
2008-10-24,1.56,548634,854027,1402661,0,0,0
2008-10-27,1.75,398867,699928,1098795,0,0,0
2008-10-28,1.32,529993,698790,1228783,0,0,0
2008-10-29,0.95,619064,585506,1204570,0,0,0
2008-10-30,0.75,434191,326685,760876,0,0,0
2008-10-31,0.97,481100,464365,945465,0,0,0
2008-11-03,1.29,320705,414765,735470,0,0,0
2008-11-04,1.38,536932,740983,1277915,0,0,0
2008-11-05,1.35,445915,603451,1049366,0,0,0
2008-11-06,1.87,448415,840256,1288671,0,0,0
2008-11-07,1.09,439529,480967,920496,0,0,0
2008-11-10,1.49,348654,519137,867791,0,0,0
2008-11-11,1.42,463852,659130,1122982,0,0,0
2008-11-12,1.52,584493,887471,1471964,0,0,0
2008-11-13,1.04,864631,901902,1766533,0,0,0
2008-11-14,1.17,646081,756313,1402394,0,0,0
2008-11-17,0.88,639231,565100,1204331,0,0,0
2008-11-18,1.44,583827,840476,1424303,0,0,0
2008-11-19,1.48,699325,1031624,1730949,0,0,0
2008-11-20,1.6,856145,1367569,2223714,0,0,0
2008-11-21,1.09,1107536,1209612,2317148,0,0,0
2008-11-24,0.87,743857,645497,1389354,0,0,0
2008-11-25,1.0,429913,428096,858009,0,0,0
2008-11-26,0.7,602895,419111,1022006,0,0,0
2008-11-28,1.12,176064,197219,373283,0,0,0
2008-12-01,1.08,473616,512614,986230,0,0,0
2008-12-02,1.33,344483,459460,803943,0,0,0
2008-12-03,1.71,381273,651842,1033115,0,0,0
2008-12-04,1.19,425821,505366,931187,0,0,0
2008-12-05,1.35,513290,692271,1205561,0,0,0
2008-12-08,1.02,574421,587965,1162386,0,0,0
2008-12-09,0.79,631965,497817,1129782,0,0,0
2008-12-10,1.16,415311,479790,895101,0,0,0
2008-12-11,1.02,654585,665915,1320500,0,0,0
2008-12-12,1.13,389292,441414,830706,0,0,0
2008-12-15,1.26,350480,443171,793651,0,0,0
2008-12-16,1.06,562665,598357,1161022,0,0,0
2008-12-17,1.03,577447,595898,1173345,0,0,0
2008-12-18,0.96,585240,559689,1144929,0,0,0
2008-12-19,1.04,513661,535699,1049360,0,0,0
2008-12-22,0.99,289986,286758,576744,0,0,0
2008-12-23,1.0,237823,238282,476105,0,0,0
2008-12-24,0.93,100311,92853,193164,0,0,0
2008-12-26,1.0,123149,123659,246808,0,0,0
2008-12-29,1.75,218194,381367,599561,0,0,0
2008-12-30,1.02,282024,288152,570176,0,0,0
2008-12-31,0.85,372565,315380,687945,0,0,0
2009-01-02,1.24,449060,556479,1005539,0,0,0
2009-01-05,1.13,387619,437630,825249,0,0,0
2009-01-06,0.85,549346,467660,1017006,0,0,0
2009-01-07,1.38,391284,539832,931116,0,0,0
2009-01-08,1.32,313881,415269,729150,0,0,0
2009-01-09,1.23,347421,428936,776357,0,0,0
2009-01-12,1.64,374290,614897,989187,0,0,0
2009-01-13,1.1,437545,482317,919862,0,0,0
2009-01-14,1.57,539594,845424,1385018,0,0,0
2009-01-15,1.59,663262,1051745,1715007,0,0,0
2009-01-16,1.12,661867,740625,1402492,0,0,0
2009-01-20,1.3,442552,573184,1015736,0,0,0
2009-01-21,1.06,433805,459979,893784,0,0,0
2009-01-22,1.02,438350,446101,884451,0,0,0
2009-01-23,0.88,585444,512977,1098421,0,0,0
2009-01-26,0.9,511977,461629,973606,0,0,0
2009-01-27,0.86,369493,317197,686690,0,0,0
2009-01-28,1.13,560630,633003,1193633,0,0,0
2009-01-29,0.95,394146,374442,768588,0,0,0
2009-01-30,1.42,348126,493288,841414,0,0,0
2009-02-02,1.08,367075,395466,762541,0,0,0
2009-02-03,0.79,593677,471390,1065067,0,0,0
2009-02-04,1.25,468096,582947,1051043,0,0,0
2009-02-05,0.62,642956,397607,1040563,0,0,0
2009-02-06,0.96,725595,694871,1420466,0,0,0
2009-02-09,0.51,563894,287638,851532,0,0,0
2009-02-10,1.35,511589,688993,1200582,0,0,0
2009-02-11,1.16,400592,465839,866431,0,0,0
2009-02-12,0.98,476990,469810,946800,0,0,0
2009-02-13,0.97,458355,445503,903858,0,0,0
2009-02-17,1.04,599806,625976,1225782,0,0,0
2009-02-18,1.61,492609,794237,1286846,0,0,0
2009-02-19,1.37,513811,701662,1215473,0,0,0
2009-02-20,1.73,811174,1399439,2210613,0,0,0
2009-02-23,1.0,525886,525415,1051301,0,0,0
2009-02-24,0.91,583750,533915,1117665,0,0,0
2009-02-25,1.06,587146,624431,1211577,0,0,0
2009-02-26,0.58,488501,285332,773833,0,0,0
2009-02-27,1.75,382224,668675,1050899,0,0,0
2009-03-02,1.37,673856,921768,1595624,0,0,0
2009-03-03,0.98,652936,638659,1291595,0,0,0
2009-03-04,0.84,646326,544559,1190885,0,0,0
2009-03-05,1.19,697520,831008,1528528,0,0,0
2009-03-06,0.88,785479,689319,1474798,0,0,0
2009-03-09,0.79,846522,668647,1515169,0,0,0
2009-03-10,0.88,851361,751484,1602845,0,0,0
2009-03-11,0.75,624714,469810,1094524,0,0,0
2009-03-12,0.77,898414,693406,1591820,0,0,0
2009-03-13,0.85,574704,490396,1065100,0,0,0
2009-03-16,0.8,832648,663207,1495855,0,0,0
2009-03-17,1.32,633938,836520,1470458,0,0,0
2009-03-18,0.7,1059015,741265,1800280,0,0,0
2009-03-19,1.07,873724,935285,1809009,0,0,0
2009-03-20,0.96,811261,777055,1588316,0,0,0
2009-03-23,1.07,693124,744262,1437386,0,0,0
2009-03-24,1.02,496710,506943,1003653,0,0,0
2009-03-25,1.2,536667,646494,1183161,0,0,0
2009-03-26,1.31,518855,677824,1196679,0,0,0
2009-03-27,1.17,345971,405042,751013,0,0,0
2009-03-30,1.39,393703,548868,942571,0,0,0
2009-03-31,0.95,415066,395302,810368,0,0,0
2009-04-01,1.19,385973,459946,845919,0,0,0
2009-04-02,0.69,900311,624473,1524784,0,0,0
2009-04-03,0.98,516768,504307,1021075,0,0,0
2009-04-06,1.53,323704,493991,817695,0,0,0
2009-04-07,1.18,437422,514572,951994,0,0,0
2009-04-08,1.24,312791,387943,700734,0,0,0
2009-04-09,0.96,614186,592552,1206738,0,0,0
2009-04-13,0.78,590801,462404,1053205,0,0,0
2009-04-14,1.29,510423,657394,1167817,0,0,0
2009-04-15,1.72,454108,781791,1235899,0,0,0
2009-04-16,0.96,690945,663011,1353956,0,0,0
2009-04-17,1.05,757818,793312,1551130,0,0,0
2009-04-20,1.18,538154,637026,1175180,0,0,0
2009-04-21,1.1,535757,588569,1124326,0,0,0
2009-04-22,0.93,651975,603245,1255220,0,0,0
2009-04-23,1.36,393900,536752,930652,0,0,0
2009-04-24,1.17,535590,626271,1161861,0,0,0
2009-04-27,1.06,466524,492189,958713,0,0,0
2009-04-28,1.48,301423,444628,746051,0,0,0
2009-04-29,1.09,551215,603011,1154226,0,0,0
2009-04-30,1.64,438692,717388,1156080,0,0,0
2009-05-01,1.23,381393,468074,849467,0,0,0
2009-05-04,1.14,493280,562803,1056083,0,0,0
2009-05-05,0.94,618305,578271,1196576,0,0,0
2009-05-06,1.1,846696,930767,1777463,0,0,0
2009-05-07,1.07,778860,832631,1611491,0,0,0
2009-05-08,1.37,646315,887943,1534258,0,0,0
2009-05-11,1.38,466051,643465,1109516,0,0,0
2009-05-12,1.19,580562,688688,1269250,0,0,0
2009-05-13,1.23,651066,803280,1454346,0,0,0
2009-05-14,1.21,660583,800877,1461460,0,0,0
2009-05-15,1.23,614155,752863,1367018,0,0,0
2009-05-18,1.08,488503,528007,1016510,0,0,0
2009-05-19,1.31,477887,626684,1104571,0,0,0
2009-05-20,1.3,596244,776948,1373192,0,0,0
2009-05-21,1.34,541588,724180,1265768,0,0,0
2009-05-22,1.27,312158,395498,707656,0,0,0
2009-05-26,1.18,377801,444970,822771,0,0,0
2009-05-27,1.3,429613,557869,987482,0,0,0
2009-05-28,0.83,535267,446861,982128,0,0,0
2009-05-29,1.0,458562,458124,916686,0,0,0
2009-06-01,1.18,643461,757024,1400485,0,0,0
2009-06-02,1.15,436677,502481,939158,0,0,0
2009-06-03,1.12,424322,476540,900862,0,0,0
2009-06-04,1.44,363744,524536,888280,0,0,0
2009-06-05,1.23,469451,577882,1047333,0,0,0
2009-06-08,1.42,275675,391297,666972,0,0,0
2009-06-09,1.22,341103,416425,757528,0,0,0
2009-06-10,1.0,475621,475574,951195,0,0,0
2009-06-11,1.17,453706,531837,985543,0,0,0
2009-06-12,1.3,451670,588796,1040466,0,0,0
2009-06-15,1.15,559041,642555,1201596,0,0,0
2009-06-16,1.32,526555,694352,1220907,0,0,0
2009-06-17,1.47,549240,805318,1354558,0,0,0
2009-06-18,1.15,594205,683738,1277943,0,0,0
2009-06-19,1.41,674687,948352,1623039,0,0,0
2009-06-22,1.49,434702,648063,1082765,0,0,0
2009-06-23,1.55,339006,523776,862782,0,0,0
2009-06-24,1.35,377376,507922,885298,0,0,0
2009-06-25,1.28,392436,501908,894344,0,0,0
2009-06-26,1.36,288801,392188,680989,0,0,0
2009-06-29,0.88,416172,366638,782810,0,0,0
2009-06-30,1.36,394785,537512,932297,0,0,0
2009-07-01,0.79,449340,356549,805889,0,0,0
2009-07-02,1.75,377238,659409,1036647,0,0,0
2009-07-06,1.24,397529,494035,891564,0,0,0
2009-07-07,1.56,401082,627121,1028203,0,0,0
2009-07-08,1.43,600041,860839,1460880,0,0,0
2009-07-09,1.87,368774,690301,1059075,0,0,0
2009-07-10,1.84,387865,714555,1102420,0,0,0
2009-07-13,1.01,621298,626271,1247569,0,0,0
2009-07-14,0.69,591398,405804,997202,0,0,0
2009-07-15,1.06,869940,918991,1788931,0,0,0
2009-07-16,0.96,629248,600948,1230196,0,0,0
2009-07-17,1.1,525055,578640,1103695,0,0,0
2009-07-20,1.11,402191,444721,846912,0,0,0
2009-07-21,1.32,299775,397148,696923,0,0,0
2009-07-22,1.23,405826,498312,904138,0,0,0
2009-07-23,1.24,625162,774149,1399311,0,0,0
2009-07-24,1.38,309012,426813,735825,0,0,0
2009-07-27,1.38,320857,442346,763203,0,0,0
2009-07-28,1.13,370333,419062,789395,0,0,0
2009-07-29,1.74,399216,692789,1092005,0,0,0
2009-07-30,0.94,555727,522047,1077774,0,0,0
2009-07-31,1.29,370146,477071,847217,0,0,0
2009-08-03,1.0,497818,499929,997747,0,0,0
2009-08-04,1.49,426136,635259,1061395,0,0,0
2009-08-05,1.22,395159,483027,878186,0,0,0
2009-08-06,1.85,356328,658579,1014907,0,0,0
2009-08-07,1.29,526140,676543,1202683,0,0,0
2009-08-10,1.4,308156,430212,738368,0,0,0
2009-08-11,1.24,337566,418085,755651,0,0,0
2009-08-12,1.84,357221,655778,1012999,0,0,0
2009-08-13,1.79,343141,613371,956512,0,0,0
2009-08-14,1.88,373695,702228,1075923,0,0,0
2009-08-17,1.51,483999,732676,1216675,0,0,0
2009-08-18,1.54,363219,560043,923262,0,0,0
2009-08-19,1.45,445335,643560,1088895,0,0,0
2009-08-20,1.2,491661,591756,1083417,0,0,0
2009-08-21,0.92,736628,675007,1411635,0,0,0
2009-08-24,1.24,346969,430856,777825,0,0,0
2009-08-25,1.39,369261,515109,884370,0,0,0
2009-08-26,2.19,271194,594888,866082,0,0,0
2009-08-27,1.38,370148,509158,879306,0,0,0
2009-08-28,1.37,386892,529995,916887,0,0,0
2009-08-31,1.45,326102,474164,800266,0,0,0
2009-09-01,1.54,641209,985667,1626876,0,0,0
2009-09-02,1.43,468971,669735,1138706,0,0,0
2009-09-03,1.7,407485,691213,1098698,0,0,0
2009-09-04,1.44,442581,638227,1080808,0,0,0
2009-09-08,1.09,463565,503098,966663,0,0,0
2009-09-09,1.18,729611,861973,1591584,0,0,0
2009-09-10,1.24,520287,643321,1163608,0,0,0
2009-09-11,1.16,667755,774657,1442412,0,0,0
2009-09-14,1.37,397023,544074,941097,0,0,0
2009-09-15,1.22,524561,641165,1165726,0,0,0
2009-09-16,0.91,848519,772848,1621367,0,0,0
2009-09-17,1.46,670398,980396,1650794,0,0,0
2009-09-18,1.47,541943,796032,1337975,0,0,0
2009-09-21,0.75,500440,373390,873830,0,0,0
2009-09-22,1.25,309212,385771,694983,0,0,0
2009-09-23,1.82,412991,751985,1164976,0,0,0
2009-09-24,1.42,501657,710530,1212187,0,0,0
2009-09-25,1.5,432178,647300,1079478,0,0,0
2009-09-28,1.93,247690,477378,725068,0,0,0
2009-09-29,1.36,348893,475405,824298,0,0,0
2009-09-30,2.01,440830,884660,1325490,0,0,0
2009-10-01,1.39,616113,858563,1474676,0,0,0
2009-10-02,1.51,469628,708990,1178618,0,0,0
2009-10-05,1.5,320726,481431,802157,0,0,0
2009-10-06,1.46,497073,723851,1220924,0,0,0
2009-10-07,1.39,278577,387886,666463,0,0,0
2009-10-08,1.17,494786,578677,1073463,0,0,0
2009-10-09,1.15,336451,386663,723114,0,0,0
2009-10-12,1.2,353310,424982,778292,0,0,0
2009-10-13,1.2,335457,402753,738210,0,0,0
2009-10-14,0.9,680023,613989,1294012,0,0,0
2009-10-15,1.25,474580,594646,1069226,0,0,0
2009-10-16,0.99,614521,610111,1224632,0,0,0
2009-10-19,1.52,339123,516922,856045,0,0,0
2009-10-20,1.49,301181,450025,751206,0,0,0
2009-10-21,1.99,357258,710234,1067492,0,0,0
2009-10-22,1.26,423227,532163,955390,0,0,0
2009-10-23,1.29,361842,467318,829160,0,0,0
2009-10-26,1.24,430873,533800,964673,0,0,0
2009-10-27,1.48,338851,502310,841161,0,0,0
2009-10-28,1.94,478018,927669,1405687,0,0,0
2009-10-29,1.45,441478,638583,1080061,0,0,0
2009-10-30,1.82,603809,1101012,1704821,0,0,0
2009-11-02,1.44,702246,1009251,1711497,0,0,0
2009-11-03,1.0,486566,486994,973560,0,0,0
2009-11-04,1.07,589509,629918,1219427,0,0,0
2009-11-05,1.0,513185,515451,1028636,0,0,0
2009-11-06,1.36,488765,666102,1154867,0,0,0
2009-11-09,1.56,407306,636109,1043415,0,0,0
2009-11-10,1.09,406981,441690,848671,0,0,0
2009-11-11,1.03,530504,545178,1075682,0,0,0
2009-11-12,0.95,532012,505195,1037207,0,0,0
2009-11-13,1.07,360530,385747,746277,0,0,0
2009-11-16,1.12,562098,631652,1193750,0,0,0
2009-11-17,1.17,416953,486784,903737,0,0,0
2009-11-18,1.04,528581,548420,1077001,0,0,0
2009-11-19,1.19,580686,690471,1271157,0,0,0
2009-11-20,1.08,587184,633280,1220464,0,0,0
2009-11-23,0.88,564861,499520,1064381,0,0,0
2009-11-24,1.5,284042,426220,710262,0,0,0
2009-11-25,1.2,422537,508401,930938,0,0,0
2009-11-27,1.09,478208,519205,997413,0,0,0
2009-11-30,1.2,472961,566831,1039792,0,0,0
2009-12-01,1.13,540170,609352,1149522,0,0,0
2009-12-02,1.11,499019,554639,1053658,0,0,0
2009-12-03,1.26,463421,582662,1046083,0,0,0
2009-12-04,0.91,923226,842815,1766041,0,0,0
2009-12-07,1.22,365224,446666,811890,0,0,0
2009-12-08,1.17,553236,649908,1203144,0,0,0
2009-12-09,1.55,444557,689657,1134214,0,0,0
2009-12-10,1.2,570408,685906,1256314,0,0,0
2009-12-11,1.46,395253,577377,972630,0,0,0
2009-12-14,1.39,430120,597882,1028002,0,0,0
2009-12-15,1.28,446229,570655,1016884,0,0,0
2009-12-16,0.91,605221,551941,1157162,0,0,0
2009-12-17,1.34,830368,1111344,1941712,0,0,0
2009-12-18,1.38,725394,1004225,1729619,0,0,0
2009-12-21,0.62,993088,611895,1604983,0,0,0
2009-12-22,0.36,1332039,474673,1806712,0,0,0
2009-12-23,1.21,446966,539129,986095,0,0,0
2009-12-24,0.96,207150,199029,406179,0,0,0
2009-12-28,1.16,360365,418434,778799,0,0,0
2009-12-29,1.13,355125,400834,755959,0,0,0
2009-12-30,1.13,322630,365390,688020,0,0,0
2009-12-31,1.11,366487,404991,771478,0,0,0
2010-01-04,0.98,422628,415916,838544,0,0,0
2010-01-05,0.84,373781,314721,688502,0,0,0
2010-01-06,0.85,476743,406004,882747,0,0,0
2010-01-07,1.4,431292,603129,1034421,0,0,0
2010-01-08,1.06,401602,427157,828759,0,0,0
2010-01-11,1.0,484816,482852,967668,0,0,0
2010-01-12,1.09,490415,533501,1023916,0,0,0
2010-01-13,1.51,443680,670024,1113704,0,0,0
2010-01-14,1.15,438739,502585,941324,0,0,0
2010-01-15,1.16,709781,823814,1533595,0,0,0
2010-01-19,1.05,423083,443139,866222,0,0,0
2010-01-20,1.25,449740,564219,1013959,0,0,0
2010-01-21,1.46,548477,800516,1348993,0,0,0
2010-01-22,1.85,601038,1112860,1713898,0,0,0
2010-01-25,1.33,468769,623167,1091936,0,0,0
2010-01-26,1.23,451183,553029,1004212,0,0,0
2010-01-27,1.54,538460,831236,1369696,0,0,0
2010-01-28,0.97,547285,529076,1076361,0,0,0
2010-01-29,1.39,459210,636828,1096038,0,0,0
2010-02-01,0.98,579438,568394,1147832,0,0,0
2010-02-02,1.22,357207,435596,792803,0,0,0
2010-02-03,1.19,359452,429143,788595,0,0,0
2010-02-04,1.8,522675,942181,1464856,0,0,0
2010-02-05,1.84,734402,1350278,2084680,0,0,0
2010-02-08,1.53,316023,483631,799654,0,0,0
2010-02-09,1.65,453329,748431,1201760,0,0,0
2010-02-10,1.54,346965,533773,880738,0,0,0
2010-02-11,1.89,371235,703479,1074714,0,0,0
2010-02-12,1.58,310571,490079,800650,0,0,0
2010-02-16,1.14,398569,454558,853127,0,0,0
2010-02-17,1.3,514623,668470,1183093,0,0,0
2010-02-18,0.86,663249,568442,1231691,0,0,0
2010-02-19,1.21,668860,809234,1478094,0,0,0
2010-02-22,1.22,344598,420583,765181,0,0,0
2010-02-23,1.54,359564,553862,913426,0,0,0
2010-02-24,1.19,328760,390114,718874,0,0,0
2010-02-25,1.68,383894,643852,1027746,0,0,0
2010-02-26,1.05,325364,342773,668137,0,0,0
2010-03-01,1.84,357672,657989,1015661,0,0,0
2010-03-02,1.23,453693,556057,1009750,0,0,0
2010-03-03,1.11,334802,371744,706546,0,0,0
2010-03-04,1.55,272675,423508,696183,0,0,0
2010-03-05,1.1,533721,588776,1122497,0,0,0
2010-03-08,2.04,285548,581983,867531,0,0,0
2010-03-09,1.46,465925,679079,1145004,0,0,0
2010-03-10,2.14,468733,1004353,1473086,0,0,0
2010-03-11,2.29,336035,770750,1106785,0,0,0
2010-03-12,1.37,402585,552346,954931,0,0,0
2010-03-15,1.48,338931,503127,842058,0,0,0
2010-03-16,1.29,405047,523015,928062,0,0,0
2010-03-17,1.35,608593,818704,1427297,0,0,0
2010-03-18,0.95,604728,573532,1178260,0,0,0
2010-03-19,1.58,445650,703845,1149495,0,0,0
2010-03-22,1.77,365384,645817,1011201,0,0,0
2010-03-23,0.59,825001,483158,1308159,0,0,0
2010-03-24,1.39,351092,488757,839849,0,0,0
2010-03-25,1.61,493314,794432,1287746,0,0,0
2010-03-26,1.58,328579,517892,846471,0,0,0
2010-03-29,1.2,294032,351809,645841,0,0,0
2010-03-30,1.92,251244,482842,734086,0,0,0
2010-03-31,1.25,358005,448952,806957,0,0,0
2010-04-01,1.25,430002,535471,965473,0,0,0
2010-04-05,1.4,368551,515441,883992,0,0,0
2010-04-06,1.29,426250,550318,976568,0,0,0
2010-04-07,1.31,502885,657199,1160084,0,0,0
2010-04-08,1.57,389350,613037,1002387,0,0,0
2010-04-09,0.83,666137,553856,1219993,0,0,0
2010-04-12,1.49,317108,472169,789277,0,0,0
2010-04-13,1.34,379475,509835,889310,0,0,0
2010-04-14,1.22,591753,723923,1315676,0,0,0
2010-04-15,1.85,500166,926185,1426351,0,0,0
2010-04-16,1.59,895708,1424210,2319918,0,0,0
2010-04-19,2.21,564182,1247734,1811916,0,0,0
2010-04-20,1.72,335391,578441,913832,0,0,0
2010-04-21,1.86,361877,674736,1036613,0,0,0
2010-04-22,1.26,558998,703484,1262482,0,0,0
2010-04-23,1.5,409767,613490,1023257,0,0,0
2010-04-26,1.37,325053,445892,770945,0,0,0
2010-04-27,1.51,620106,936065,1556171,0,0,0
2010-04-28,1.41,466248,658253,1124501,0,0,0
2010-04-29,1.05,570563,599326,1169889,0,0,0
2010-04-30,2.13,443232,945100,1388332,0,0,0
2010-05-03,1.52,362869,550533,913402,0,0,0
2010-05-04,1.59,805440,1283212,2088652,0,0,0
2010-05-05,2.17,670130,1455258,2125388,0,0,0
2010-05-06,1.48,1380369,2041793,3422162,0,0,0
2010-05-07,1.75,1225424,2146467,3371891,0,0,0
2010-05-10,1.59,764377,1214130,1978507,0,0,0
2010-05-11,1.53,598888,914303,1513191,0,0,0
2010-05-12,1.33,598452,795678,1394130,0,0,0
2010-05-13,1.43,574421,820859,1395280,0,0,0
2010-05-14,1.95,864240,1681047,2545287,0,0,0
2010-05-17,1.44,672374,969521,1641895,0,0,0
2010-05-18,1.6,651442,1041277,1692719,0,0,0
2010-05-19,1.81,805343,1455674,2261017,0,0,0
2010-05-20,2.44,1025904,2502328,3528232,0,0,0
2010-05-21,1.82,1096978,1991401,3088379,0,0,0
2010-05-24,1.43,501412,717175,1218587,0,0,0
2010-05-25,1.74,680341,1185032,1865373,0,0,0
2010-05-26,2.1,480973,1008111,1489084,0,0,0
2010-05-27,2.14,449127,963053,1412180,0,0,0
2010-05-28,2.61,400537,1043863,1444400,0,0,0
2010-06-01,1.61,363637,585105,948742,0,0,0
2010-06-02,1.82,347784,632960,980744,0,0,0
2010-06-03,1.94,440147,852714,1292861,0,0,0
2010-06-04,1.72,498036,855532,1353568,0,0,0
2010-06-07,1.72,537369,926041,1463410,0,0,0
2010-06-08,1.79,576202,1032557,1608759,0,0,0
2010-06-09,1.45,450685,652048,1102733,0,0,0
2010-06-10,1.5,517510,774934,1292444,0,0,0
2010-06-11,1.91,361458,689545,1051003,0,0,0
2010-06-14,1.05,575796,603035,1178831,0,0,0
2010-06-15,1.2,573071,687836,1260907,0,0,0
2010-06-16,1.22,482708,587297,1070005,0,0,0
2010-06-17,1.25,609146,763835,1372981,0,0,0
2010-06-18,1.09,559841,608088,1167929,0,0,0
2010-06-21,1.25,487817,609344,1097161,0,0,0
2010-06-22,1.93,377089,726416,1103505,0,0,0
2010-06-23,1.88,364018,682865,1046883,0,0,0
2010-06-24,3.24,345323,1118147,1463470,0,0,0
2010-06-25,1.17,359542,419571,779113,0,0,0
2010-06-28,1.02,296167,302096,598263,0,0,0
2010-06-29,1.61,626478,1008625,1635103,0,0,0
2010-06-30,2.3,354803,814694,1169497,0,0,0
2010-07-01,2.12,634177,1345848,1980025,0,0,0
2010-07-02,1.28,387342,497599,884941,0,0,0
2010-07-06,2.25,400105,901433,1301538,0,0,0
2010-07-07,1.89,353489,666512,1020001,0,0,0
2010-07-08,1.27,355408,450800,806208,0,0,0
2010-07-09,1.37,352529,484548,837077,0,0,0
2010-07-12,1.55,244174,379609,623783,0,0,0
2010-07-13,1.49,407898,606503,1014401,0,0,0
2010-07-14,2.06,374705,770804,1145509,0,0,0
2010-07-15,1.88,362873,681841,1044714,0,0,0
2010-07-16,1.81,512217,929092,1441309,0,0,0
2010-07-19,1.23,323595,397141,720736,0,0,0
2010-07-20,1.2,458128,548943,1007071,0,0,0
2010-07-21,1.72,258895,444170,703065,0,0,0
2010-07-22,1.43,418598,597659,1016257,0,0,0
2010-07-23,1.7,271122,459624,730746,0,0,0
2010-07-26,2.03,346697,703949,1050646,0,0,0
2010-07-27,1.51,276930,419459,696389,0,0,0
2010-07-28,1.51,251526,379487,631013,0,0,0
2010-07-29,1.79,333980,596647,930627,0,0,0
2010-07-30,1.21,283771,342736,626507,0,0,0
2010-08-02,1.24,330990,409293,740283,0,0,0
2010-08-03,1.93,197465,380363,577828,0,0,0
2010-08-04,1.26,249005,313809,562814,0,0,0
2010-08-05,1.63,229422,373689,603111,0,0,0
2010-08-06,1.49,385425,573721,959146,0,0,0
2010-08-09,1.28,206855,265438,472293,0,0,0
2010-08-10,1.37,306464,421224,727688,0,0,0
2010-08-11,1.62,468262,757854,1226116,0,0,0
2010-08-12,1.54,409998,630775,1040773,0,0,0
2010-08-13,1.44,304242,439087,743329,0,0,0
2010-08-16,1.2,309314,371551,680865,0,0,0
2010-08-17,1.23,335006,411685,746691,0,0,0
2010-08-18,2.54,306489,778474,1084963,0,0,0
2010-08-19,1.48,462986,686855,1149841,0,0,0
2010-08-20,1.48,503474,743645,1247119,0,0,0
2010-08-23,1.58,317964,502868,820832,0,0,0
2010-08-24,1.68,368531,617330,985861,0,0,0
2010-08-25,1.55,448254,694206,1142460,0,0,0
2010-08-26,1.55,355200,549272,904472,0,0,0
2010-08-27,1.24,433042,536652,969694,0,0,0
2010-08-30,1.43,224122,321160,545282,0,0,0
2010-08-31,0.89,366762,327976,694738,0,0,0
2010-09-01,1.17,413631,481921,895552,0,0,0
2010-09-02,1.52,288718,437465,726183,0,0,0
2010-09-03,1.01,539405,545516,1084921,0,0,0
2010-09-07,3.34,241358,806520,1047878,0,0,0
2010-09-08,1.57,339473,532232,871705,0,0,0
2010-09-09,1.48,286499,423512,710011,0,0,0
2010-09-10,2.88,247293,712871,960164,0,0,0
2010-09-13,1.38,364922,502151,867073,0,0,0
2010-09-14,1.05,415166,437940,853106,0,0,0
2010-09-15,1.61,464534,746275,1210809,0,0,0
2010-09-16,1.36,544896,742197,1287093,0,0,0
2010-09-17,1.62,461298,748665,1209963,0,0,0
2010-09-20,1.29,434593,558462,993055,0,0,0
2010-09-21,1.31,384524,502421,886945,0,0,0
2010-09-22,1.44,280596,404226,684822,0,0,0
2010-09-23,1.71,329712,564656,894368,0,0,0
2010-09-24,1.6,357167,571429,928596,0,0,0
2010-09-27,1.29,223865,288559,512424,0,0,0
2010-09-28,1.4,305092,428237,733329,0,0,0
2010-09-29,1.06,370007,390477,760484,0,0,0
2010-09-30,1.34,493687,662793,1156480,0,0,0
2010-10-01,0.97,608342,591234,1199576,0,0,0
2010-10-04,1.47,279982,410539,690521,0,0,0
2010-10-05,1.2,522702,628308,1151010,0,0,0
2010-10-06,1.14,464527,530732,995259,0,0,0
2010-10-07,2.11,415091,874675,1289766,0,0,0
2010-10-08,1.35,433301,586038,1019339,0,0,0
2010-10-11,1.33,281022,373199,654221,0,0,0
2010-10-12,2.43,352248,856712,1208960,0,0,0
2010-10-13,1.4,604623,846520,1451143,0,0,0
2010-10-14,1.19,539566,643887,1183453,0,0,0
2010-10-15,0.86,972989,834461,1807450,0,0,0
2010-10-18,2.03,318642,646792,965434,0,0,0
2010-10-19,1.32,488026,642128,1130154,0,0,0
2010-10-20,1.6,367524,589545,957069,0,0,0
2010-10-21,1.68,383733,644162,1027895,0,0,0
2010-10-22,1.38,245991,340596,586587,0,0,0
2010-10-25,1.23,326241,402341,728582,0,0,0
2010-10-26,1.2,322921,388460,711381,0,0,0
2010-10-27,1.23,323975,399429,723404,0,0,0
2010-10-28,1.55,317594,491765,809359,0,0,0
2010-10-29,1.26,385447,487538,872985,0,0,0
2010-11-01,1.2,380738,458619,839357,0,0,0
2010-11-02,1.3,393696,512325,906021,0,0,0
2010-11-03,1.42,499218,708638,1207856,0,0,0
2010-11-04,1.03,907146,937533,1844679,0,0,0
2010-11-05,1.25,572061,715938,1287999,0,0,0
2010-11-08,1.09,390432,425785,816217,0,0,0
2010-11-09,1.22,635070,775535,1410605,0,0,0
2010-11-10,1.09,502955,547522,1050477,0,0,0
2010-11-11,1.35,372233,501767,874000,0,0,0
2010-11-12,1.97,476249,938332,1414581,0,0,0
2010-11-15,1.5,313257,471448,784705,0,0,0
2010-11-16,1.18,737363,872564,1609927,0,0,0
2010-11-17,1.22,406061,496809,902870,0,0,0
2010-11-18,1.53,474628,724300,1198928,0,0,0
2010-11-19,1.07,554799,591716,1146515,0,0,0
2010-11-22,1.33,332734,442262,774996,0,0,0
2010-11-23,1.18,388119,459239,847358,0,0,0
2010-11-24,2.69,298828,802790,1101618,0,0,0
2010-11-26,1.53,172613,264609,437222,0,0,0
2010-11-29,1.42,309615,441147,750762,0,0,0
2010-11-30,1.29,344378,442803,787181,0,0,0
2010-12-01,1.6,371009,593538,964547,0,0,0
2010-12-02,1.19,433398,517169,950567,0,0,0
2010-12-03,1.13,385131,434097,819228,0,0,0
2010-12-06,1.22,293330,357913,651243,0,0,0
2010-12-07,1.63,406016,660414,1066430,0,0,0
2010-12-08,1.19,321128,383729,704857,0,0,0
2010-12-09,1.36,321209,437985,759194,0,0,0
2010-12-10,1.44,362560,522660,885220,0,0,0
2010-12-13,1.05,385824,405968,791792,0,0,0
2010-12-14,2.37,375167,888415,1263582,0,0,0
2010-12-15,1.12,365098,408811,773909,0,0,0
2010-12-16,2.45,453458,1109137,1562595,0,0,0
2010-12-17,1.36,462224,629949,1092173,0,0,0
2010-12-20,0.87,502700,436158,938858,0,0,0
2010-12-21,1.26,302777,382953,685730,0,0,0
2010-12-22,1.25,331739,414111,745850,0,0,0
2010-12-23,2.02,208162,419812,627974,0,0,0
2010-12-27,1.28,213144,272075,485219,0,0,0
2010-12-28,1.37,196786,269412,466198,0,0,0
2010-12-29,1.02,218785,223675,442460,0,0,0
2010-12-30,0.67,440885,294230,735115,0,0,0
2010-12-31,1.52,265774,404219,669993,0,0,0
2011-01-03,1.36,410481,557887,968368,0,0,0
2011-01-04,1.18,451421,532859,984280,0,0,0
2011-01-05,1.32,373605,494074,867679,0,0,0
2011-01-06,2.23,335986,747995,1083981,0,0,0
2011-01-07,2.17,427272,929227,1356499,0,0,0
2011-01-10,1.53,306832,470849,777681,0,0,0
2011-01-11,1.81,280385,507576,787961,0,0,0
2011-01-12,1.88,486050,915291,1401341,0,0,0
2011-01-13,1.58,364580,576073,940653,0,0,0
2011-01-14,1.3,474554,617519,1092073,0,0,0
2011-01-18,2.23,345726,771211,1116937,0,0,0
2011-01-19,1.48,520510,767934,1288444,0,0,0
2011-01-20,1.4,638723,895134,1533857,0,0,0
2011-01-21,1.49,584207,867729,1451936,0,0,0
2011-01-24,1.33,350786,465272,816058,0,0,0
2011-01-25,1.96,335838,659296,995134,0,0,0
2011-01-26,2.28,301929,687216,989145,0,0,0
2011-01-27,2.21,296395,656352,952747,0,0,0
2011-01-28,1.88,611681,1147055,1758736,0,0,0
2011-01-31,1.6,400750,639520,1040270,0,0,0
2011-02-01,1.72,566836,972497,1539333,0,0,0
2011-02-02,1.78,314236,558479,872715,0,0,0
2011-02-03,1.53,398032,607201,1005233,0,0,0
2011-02-04,1.47,426646,627112,1053758,0,0,0
2011-02-07,1.71,392675,673378,1066053,0,0,0
2011-02-08,1.55,362419,563502,925921,0,0,0
2011-02-09,1.65,431877,710646,1142523,0,0,0
2011-02-10,1.94,339446,658068,997514,0,0,0
2011-02-11,1.5,472059,707358,1179417,0,0,0
2011-02-14,1.73,299409,519317,818726,0,0,0
2011-02-15,2.07,345402,714784,1060186,0,0,0
2011-02-16,1.41,529267,746178,1275445,0,0,0
2011-02-17,1.2,468563,562576,1031139,0,0,0
2011-02-18,1.59,632581,1008841,1641422,0,0,0
2011-02-22,1.4,597614,836160,1433774,0,0,0
2011-02-23,1.51,722153,1091473,1813626,0,0,0
2011-02-24,1.35,580757,785943,1366700,0,0,0
2011-02-25,1.35,411071,555040,966111,0,0,0
2011-02-28,1.04,412998,427812,840810,0,0,0
2011-03-01,1.43,426637,609598,1036235,0,0,0
2011-03-02,1.41,368837,518285,887122,0,0,0
2011-03-03,1.43,408970,583188,992158,0,0,0
2011-03-04,1.22,501578,611624,1113202,0,0,0
2011-03-07,1.64,468237,767932,1236169,0,0,0
2011-03-08,1.4,383620,537391,921011,0,0,0
2011-03-09,0.92,508571,467568,976139,0,0,0
2011-03-10,1.9,658666,1254459,1913125,0,0,0
2011-03-11,1.52,580651,881347,1461998,0,0,0
2011-03-14,1.58,385763,608256,994019,0,0,0
2011-03-15,1.91,896801,1713752,2610553,0,0,0
2011-03-16,1.74,913462,1587515,2500977,0,0,0
2011-03-17,1.78,568355,1009728,1578083,0,0,0
2011-03-18,1.48,727408,1078157,1805565,0,0,0
2011-03-21,1.25,444346,556281,1000627,0,0,0
2011-03-22,1.55,320312,497873,818185,0,0,0
2011-03-23,1.5,397896,595403,993299,0,0,0
2011-03-24,1.53,409683,625938,1035621,0,0,0
2011-03-25,1.12,685169,765407,1450576,0,0,0
2011-03-28,1.3,332205,431695,763900,0,0,0
2011-03-29,0.93,384813,358956,743769,0,0,0
2011-03-30,1.15,498385,574289,1072674,0,0,0
2011-03-31,1.25,420021,525047,945068,0,0,0
2011-04-01,1.47,462852,681526,1144378,0,0,0
2011-04-04,2.61,237985,620777,858762,0,0,0
2011-04-05,1.39,360278,500676,860954,0,0,0
2011-04-06,1.08,391061,421148,812209,0,0,0
2011-04-07,1.59,449530,716423,1165953,0,0,0
2011-04-08,1.43,560448,801951,1362399,0,0,0
2011-04-11,1.73,403689,698721,1102410,0,0,0
2011-04-12,2.48,507470,1259786,1767256,0,0,0
2011-04-13,1.9,372011,708321,1080332,0,0,0
2011-04-14,1.6,522753,838605,1361358,0,0,0
2011-04-15,1.17,803537,939825,1743362,0,0,0
2011-04-18,1.37,539608,739830,1279438,0,0,0
2011-04-19,1.85,301597,556706,858303,0,0,0
2011-04-20,1.66,581085,961759,1542844,0,0,0
2011-04-21,1.41,517857,729211,1247068,0,0,0
2011-04-25,1.19,357568,424167,781735,0,0,0
2011-04-26,1.56,499079,779364,1278443,0,0,0
2011-04-27,1.31,503578,661462,1165040,0,0,0
2011-04-28,1.39,579388,803067,1382455,0,0,0
2011-04-29,1.36,554713,754676,1309389,0,0,0
2011-05-02,1.54,431017,662724,1093741,0,0,0
2011-05-03,1.47,519531,762057,1281588,0,0,0
2011-05-04,1.43,581806,833268,1415074,0,0,0
2011-05-05,1.36,855900,1167759,2023659,0,0,0
2011-05-06,1.45,677792,982998,1660790,0,0,0
2011-05-09,1.23,356478,436924,793402,0,0,0
2011-05-10,1.17,354907,415963,770870,0,0,0
2011-05-11,1.34,488310,656295,1144605,0,0,0
2011-05-12,1.19,578992,688923,1267915,0,0,0
2011-05-13,1.41,459174,647608,1106782,0,0,0
2011-05-16,1.9,316649,601516,918165,0,0,0
2011-05-17,2.12,470600,999265,1469865,0,0,0
2011-05-18,1.67,427319,712349,1139668,0,0,0
2011-05-19,1.3,421249,545586,966835,0,0,0
2011-05-20,1.57,581488,910142,1491630,0,0,0
2011-05-23,1.34,489820,655456,1145276,0,0,0
2011-05-24,1.13,384459,435418,819877,0,0,0
2011-05-25,1.31,331204,435046,766250,0,0,0
2011-05-26,1.22,405385,493925,899310,0,0,0
2011-05-27,1.21,430417,519887,950304,0,0,0
2011-05-31,1.48,401741,593409,995150,0,0,0
2011-06-01,1.45,530375,771631,1302006,0,0,0
2011-06-02,1.56,565388,883043,1448431,0,0,0
2011-06-03,1.5,524347,785413,1309760,0,0,0
2011-06-06,1.86,424286,790309,1214595,0,0,0
2011-06-07,1.65,358141,591345,949486,0,0,0
2011-06-08,1.92,456327,874166,1330493,0,0,0
2011-06-09,1.74,349528,609478,959006,0,0,0
2011-06-10,1.6,600417,958151,1558568,0,0,0
2011-06-13,1.96,392527,770922,1163449,0,0,0
2011-06-14,1.55,438664,681637,1120301,0,0,0
2011-06-15,1.76,645173,1135907,1781080,0,0,0
2011-06-16,1.62,746748,1207254,1954002,0,0,0
2011-06-17,1.56,666467,1040858,1707325,0,0,0
2011-06-20,1.54,356261,549522,905783,0,0,0
2011-06-21,1.57,515228,811473,1326701,0,0,0
2011-06-22,1.39,373447,518199,891646,0,0,0
2011-06-23,1.37,796571,1089288,1885859,0,0,0
2011-06-24,1.31,475064,622117,1097181,0,0,0
2011-06-27,1.57,351840,552035,903875,0,0,0
2011-06-28,1.41,469798,663709,1133507,0,0,0
2011-06-29,2.04,450670,917157,1367827,0,0,0
2011-06-30,1.54,563910,869807,1433717,0,0,0
2011-07-01,1.05,674360,710981,1385341,0,0,0
2011-07-05,1.86,316943,590661,907604,0,0,0
2011-07-06,1.66,295315,490948,786263,0,0,0
2011-07-07,1.18,622748,734414,1357162,0,0,0
2011-07-08,1.89,385486,730464,1115950,0,0,0
2011-07-11,1.67,513835,856965,1370800,0,0,0
2011-07-12,1.8,414680,745248,1159928,0,0,0
2011-07-13,1.34,492155,657546,1149701,0,0,0
2011-07-14,1.56,582497,909612,1492109,0,0,0
2011-07-15,1.63,735808,1196450,1932258,0,0,0
2011-07-18,1.45,450784,651392,1102176,0,0,0
2011-07-19,1.14,484542,552318,1036860,0,0,0
2011-07-20,1.54,317184,488850,806034,0,0,0
2011-07-21,1.55,478093,743264,1221357,0,0,0
2011-07-22,1.68,333032,558364,891396,0,0,0
2011-07-25,1.96,270042,530515,800557,0,0,0
2011-07-26,1.55,263734,408821,672555,0,0,0
2011-07-27,1.77,683780,1213361,1897141,0,0,0
2011-07-28,1.14,618725,702995,1321720,0,0,0
2011-07-29,1.66,735627,1222394,1958021,0,0,0
2011-08-01,1.61,607503,977641,1585144,0,0,0
2011-08-02,1.82,765680,1390091,2155771,0,0,0
2011-08-03,2.12,831109,1758821,2589930,0,0,0
2011-08-04,1.84,1396516,2567359,3963875,0,0,0
2011-08-05,1.56,1455999,2271046,3727045,0,0,0
2011-08-08,1.68,1509835,2536420,4046255,0,0,0
2011-08-09,2.09,1043892,2182580,3226472,0,0,0
2011-08-10,1.54,1053940,1623966,2677906,0,0,0
2011-08-11,1.37,939632,1289840,2229472,0,0,0
2011-08-12,1.35,655734,886884,1542618,0,0,0
2011-08-15,1.31,688148,902149,1590297,0,0,0
2011-08-16,1.87,449120,840753,1289873,0,0,0
2011-08-17,1.88,531481,996677,1528158,0,0,0
2011-08-18,2.38,809320,1923616,2732936,0,0,0
2011-08-19,1.98,785370,1556591,2341961,0,0,0
2011-08-22,1.49,509937,759356,1269293,0,0,0
2011-08-23,1.66,540229,896532,1436761,0,0,0
2011-08-24,1.86,463634,861604,1325238,0,0,0
2011-08-25,1.87,584043,1094747,1678790,0,0,0
2011-08-26,1.45,711847,1035154,1747001,0,0,0
2011-08-29,1.25,504357,629166,1133523,0,0,0
2011-08-30,1.68,449875,757458,1207333,0,0,0
2011-08-31,2.27,539911,1225963,1765874,0,0,0
2011-09-01,1.53,426076,650139,1076215,0,0,0
2011-09-02,2.04,579536,1183568,1763104,0,0,0
2011-09-06,1.68,630688,1056615,1687303,0,0,0
2011-09-07,1.07,582751,625875,1208626,0,0,0
2011-09-08,1.85,410303,758496,1168799,0,0,0
2011-09-09,1.83,773560,1419002,2192562,0,0,0
2011-09-12,1.87,556135,1038745,1594880,0,0,0
2011-09-13,1.92,490138,939293,1429431,0,0,0
2011-09-14,1.41,728537,1025164,1753701,0,0,0
2011-09-15,1.26,771589,969468,1741057,0,0,0
2011-09-16,1.42,912502,1292493,2204995,0,0,0
2011-09-19,1.58,493614,781098,1274712,0,0,0
2011-09-20,1.9,494504,941386,1435890,0,0,0
2011-09-21,1.52,553010,840466,1393476,0,0,0
2011-09-22,1.59,1147334,1826644,2973978,0,0,0
2011-09-23,1.49,837184,1248701,2085885,0,0,0
2011-09-26,1.2,575655,688582,1264237,0,0,0
2011-09-27,1.67,607504,1011993,1619497,0,0,0
2011-09-28,1.9,456299,867674,1323973,0,0,0
2011-09-29,1.37,603572,824671,1428243,0,0,0
2011-09-30,1.92,624523,1196181,1820704,0,0,0
2011-10-03,1.64,689822,1130623,1820445,0,0,0
2011-10-04,1.51,1004160,1513066,2517226,0,0,0
2011-10-05,1.36,692425,940060,1632485,0,0,0
2011-10-06,1.93,583559,1125427,1708986,0,0,0
2011-10-07,1.52,708120,1075709,1783829,0,0,0
2011-10-10,2.46,450205,1105640,1555845,0,0,0
2011-10-11,1.86,326855,607990,934845,0,0,0
2011-10-12,1.92,586218,1122989,1709207,0,0,0
2011-10-13,1.57,416779,654120,1070899,0,0,0
2011-10-14,1.46,544139,794156,1338295,0,0,0
2011-10-17,1.81,419269,758531,1177800,0,0,0
2011-10-18,1.51,620575,937359,1557934,0,0,0
2011-10-19,1.47,455562,670211,1125773,0,0,0
2011-10-20,2.33,627861,1459859,2087720,0,0,0
2011-10-21,1.09,894443,973351,1867794,0,0,0
2011-10-24,1.26,498283,626408,1124691,0,0,0
2011-10-25,1.16,598404,695576,1293980,0,0,0
2011-10-26,1.35,445753,603828,1049581,0,0,0
2011-10-27,1.28,947194,1213272,2160466,0,0,0
2011-10-28,1.52,427917,649020,1076937,0,0,0
2011-10-31,1.72,351813,606006,957819,0,0,0
2011-11-01,1.74,735951,1282041,2017992,0,0,0
2011-11-02,1.68,391685,657417,1049102,0,0,0
2011-11-03,1.73,467875,811541,1279416,0,0,0
2011-11-04,1.99,359217,714940,1074157,0,0,0
2011-11-07,1.26,384552,482626,867178,0,0,0
2011-11-08,2.29,422023,967922,1389945,0,0,0
2011-11-09,1.89,575717,1090081,1665798,0,0,0
2011-11-10,1.7,376986,642266,1019252,0,0,0
2011-11-11,1.39,452606,627239,1079845,0,0,0
2011-11-14,1.95,236014,459713,695727,0,0,0
2011-11-15,2.03,347559,704323,1051882,0,0,0
2011-11-16,1.76,424668,747369,1172037,0,0,0
2011-11-17,1.71,712147,1216659,1928806,0,0,0
2011-11-18,1.44,512515,738471,1250986,0,0,0
2011-11-21,1.64,430593,707838,1138431,0,0,0
2011-11-22,1.49,388752,578301,967053,0,0,0
2011-11-23,1.74,500837,871535,1372372,0,0,0
2011-11-25,1.79,238866,428120,666986,0,0,0
2011-11-28,0.94,457095,431932,889027,0,0,0
2011-11-29,1.23,371815,458478,830293,0,0,0
2011-11-30,1.12,730542,816231,1546773,0,0,0
2011-12-01,1.07,480067,515253,995320,0,0,0
2011-12-02,1.43,553631,792203,1345834,0,0,0
2011-12-05,1.31,386270,507235,893505,0,0,0
2011-12-06,1.24,367445,455225,822670,0,0,0
2011-12-07,1.1,429487,473880,903367,0,0,0
2011-12-08,1.16,465076,540360,1005436,0,0,0
2011-12-09,1.47,606408,892749,1499157,0,0,0
2011-12-12,1.85,507090,938473,1445563,0,0,0
2011-12-13,1.37,489288,672651,1161939,0,0,0
2011-12-14,1.31,692228,905505,1597733,0,0,0
2011-12-15,1.24,492772,611528,1104300,0,0,0
2011-12-16,1.53,592268,906578,1498846,0,0,0
2011-12-19,1.38,363185,502339,865524,0,0,0
2011-12-20,1.15,433148,496981,930129,0,0,0
2011-12-21,1.26,335665,423564,759229,0,0,0
2011-12-22,1.07,391739,417821,809560,0,0,0
2011-12-23,0.97,286083,278241,564324,0,0,0
2011-12-27,1.63,216741,352439,569180,0,0,0
2011-12-28,1.34,255552,342904,598456,0,0,0
2011-12-29,1.24,365692,453211,818903,0,0,0
2011-12-30,1.17,338449,395909,734358,0,0,0
2012-01-03,1.15,365437,421866,787303,0,0,0
2012-01-04,1.24,286960,355048,642008,0,0,0
2012-01-05,1.21,349215,421367,770582,0,0,0
2012-01-06,1.22,436712,534182,970894,0,0,0
2012-01-09,1.34,288836,387861,676697,0,0,0
2012-01-10,1.2,476482,574049,1050531,0,0,0
2012-01-11,1.29,292413,377530,669943,0,0,0
2012-01-12,1.27,472199,601499,1073698,0,0,0
2012-01-13,1.33,551193,732373,1283566,0,0,0
2012-01-17,1.14,439769,502791,942560,0,0,0
2012-01-18,1.17,563210,657988,1221198,0,0,0
2012-01-19,0.93,832635,776231,1608866,0,0,0
2012-01-20,1.06,789584,838205,1627789,0,0,0
2012-01-23,1.85,453371,840937,1294308,0,0,0
2012-01-24,2.71,305539,827157,1132696,0,0,0
2012-01-25,1.48,546302,809104,1355406,0,0,0
2012-01-26,1.58,495803,782603,1278406,0,0,0
2012-01-27,1.43,423859,606835,1030694,0,0,0
2012-01-30,1.4,348843,486713,835556,0,0,0
2012-01-31,1.46,418768,609651,1028419,0,0,0
2012-02-01,1.33,497964,662061,1160025,0,0,0
2012-02-02,1.28,377418,483511,860929,0,0,0
2012-02-03,1.23,788090,972167,1760257,0,0,0
2012-02-06,1.64,278826,458532,737358,0,0,0
2012-02-07,1.32,475072,624918,1099990,0,0,0
2012-02-08,1.63,480518,781907,1262425,0,0,0
2012-02-09,1.49,505760,753843,1259603,0,0,0
2012-02-10,1.9,647524,1232107,1879631,0,0,0
2012-02-13,1.52,337221,514165,851386,0,0,0
2012-02-14,1.75,413317,721540,1134857,0,0,0
2012-02-15,1.85,591498,1093122,1684620,0,0,0
2012-02-16,1.0,716836,715146,1431982,0,0,0
2012-02-17,1.03,833417,860907,1694324,0,0,0
2012-02-21,1.54,370873,569705,940578,0,0,0
2012-02-22,1.31,408655,536551,945206,0,0,0
2012-02-23,1.54,437107,673929,1111036,0,0,0
2012-02-24,1.52,546783,828626,1375409,0,0,0
2012-02-27,1.59,365869,580421,946290,0,0,0
2012-02-28,1.25,424431,529739,954170,0,0,0
2012-02-29,1.39,528973,732952,1261925,0,0,0
2012-03-01,1.34,600065,805364,1405429,0,0,0
2012-03-02,1.58,401807,635087,1036894,0,0,0
2012-03-05,1.24,369217,456730,825947,0,0,0
2012-03-06,1.27,755328,961744,1717072,0,0,0
2012-03-07,1.29,447563,577423,1024986,0,0,0
2012-03-08,1.67,463265,774601,1237866,0,0,0
2012-03-09,0.96,697270,672746,1370016,0,0,0
2012-03-12,1.96,322217,632509,954726,0,0,0
2012-03-13,0.98,737897,724446,1462343,0,0,0
2012-03-14,1.49,744833,1108969,1853802,0,0,0
2012-03-15,0.87,936819,818860,1755679,0,0,0
2012-03-16,1.05,821792,863998,1685790,0,0,0
2012-03-19,1.55,622139,965306,1587445,0,0,0
2012-03-20,1.51,424820,641681,1066501,0,0,0
2012-03-21,1.52,458435,698381,1156816,0,0,0
2012-03-22,1.57,498936,783469,1282405,0,0,0
2012-03-23,1.56,456734,712868,1169602,0,0,0
2012-03-26,1.35,500151,677672,1177823,0,0,0
2012-03-27,1.43,391897,560143,952040,0,0,0
2012-03-28,1.26,568534,715713,1284247,0,0,0
2012-03-29,1.69,474713,801623,1276336,0,0,0
2012-03-30,1.58,483950,765296,1249246,0,0,0
2012-04-02,1.3,409767,531567,941334,0,0,0
2012-04-03,1.4,390560,548496,939056,0,0,0
2012-04-04,1.48,501312,740770,1242082,0,0,0
2012-04-05,1.38,432890,597415,1030305,0,0,0
2012-04-09,1.27,446154,564834,1010988,0,0,0
2012-04-10,1.53,754720,1152352,1907072,0,0,0
2012-04-11,2.19,371574,814956,1186530,0,0,0
2012-04-12,1.25,569452,711000,1280452,0,0,0
2012-04-13,1.45,473687,685041,1158728,0,0,0
2012-04-16,1.49,383355,570241,953596,0,0,0
2012-04-17,1.6,389848,623958,1013806,0,0,0
2012-04-18,2.03,277171,562411,839582,0,0,0
2012-04-19,1.67,539220,899112,1438332,0,0,0
2012-04-20,1.52,655874,999485,1655359,0,0,0
2012-04-23,1.35,428228,576682,1004910,0,0,0
2012-04-24,1.51,288771,435542,724313,0,0,0
2012-04-25,1.52,394217,599739,993956,0,0,0
2012-04-26,1.6,366683,587343,954026,0,0,0
2012-04-27,1.43,346891,497169,844060,0,0,0
2012-04-30,1.63,278752,453663,732415,0,0,0
2012-05-01,1.82,357543,650168,1007711,0,0,0
2012-05-02,1.92,306847,590474,897321,0,0,0
2012-05-03,1.44,498628,720353,1218981,0,0,0
2012-05-04,1.7,606521,1032292,1638813,0,0,0
2012-05-07,1.56,354647,551636,906283,0,0,0
2012-05-08,1.72,602719,1036564,1639283,0,0,0
2012-05-09,1.33,846953,1127864,1974817,0,0,0
2012-05-10,1.9,391283,744994,1136277,0,0,0
2012-05-11,2.09,540679,1128221,1668900,0,0,0
2012-05-14,1.78,497084,885973,1383057,0,0,0
2012-05-15,2.07,486018,1006891,1492909,0,0,0
2012-05-16,2.21,588927,1303307,1892234,0,0,0
2012-05-17,1.89,827430,1561313,2388743,0,0,0
2012-05-18,1.7,969620,1645175,2614795,0,0,0
2012-05-21,1.5,526757,791016,1317773,0,0,0
2012-05-22,1.76,452210,794124,1246334,0,0,0
2012-05-23,1.31,667772,874240,1542012,0,0,0
2012-05-24,1.35,534439,720734,1255173,0,0,0
2012-05-25,1.29,393967,509453,903420,0,0,0
2012-05-29,1.65,341107,563538,904645,0,0,0
2012-05-30,2.33,417548,973500,1391048,0,0,0
2012-05-31,1.36,536500,727980,1264480,0,0,0
2012-06-01,2.06,851919,1753114,2605033,0,0,0
2012-06-04,1.12,614149,687185,1301334,0,0,0
2012-06-05,1.25,546799,681319,1228118,0,0,0
2012-06-06,1.65,612734,1008335,1621069,0,0,0
2012-06-07,1.48,650764,962363,1613127,0,0,0
2012-06-08,1.29,546838,707327,1254165,0,0,0
2012-06-11,1.54,412761,637240,1050001,0,0,0
2012-06-12,1.91,449041,858851,1307892,0,0,0
2012-06-13,1.79,454229,811060,1265289,0,0,0
2012-06-14,1.25,684402,857752,1542154,0,0,0
2012-06-15,1.2,855856,1029734,1885590,0,0,0
2012-06-18,1.38,444506,614975,1059481,0,0,0
2012-06-19,2.06,506972,1044717,1551689,0,0,0
2012-06-20,1.24,643939,799549,1443488,0,0,0
2012-06-21,1.41,655343,927251,1582594,0,0,0
2012-06-22,1.62,431999,697923,1129922,0,0,0
2012-06-25,1.52,467109,708000,1175109,0,0,0
2012-06-26,1.57,294671,462089,756760,0,0,0
2012-06-27,1.36,354508,481188,835696,0,0,0
2012-06-28,1.5,463593,693169,1156762,0,0,0
2012-06-29,1.1,860213,946752,1806965,0,0,0
2012-07-02,1.49,300039,447141,747180,0,0,0
2012-07-03,1.22,312656,382329,694985,0,0,0
2012-07-05,1.41,362437,509255,871692,0,0,0
2012-07-06,1.86,347916,648554,996470,0,0,0
2012-07-09,1.63,235021,381933,616954,0,0,0
2012-07-10,2.02,392479,794213,1186692,0,0,0
2012-07-11,1.71,283896,486276,770172,0,0,0
2012-07-12,1.51,394636,595486,990122,0,0,0
2012-07-13,1.45,365734,530167,895901,0,0,0
2012-07-16,1.63,258055,420336,678391,0,0,0
2012-07-17,1.41,444422,625570,1069992,0,0,0
2012-07-18,1.36,439609,596267,1035876,0,0,0
2012-07-19,1.39,501286,696608,1197894,0,0,0
2012-07-20,1.54,573124,885409,1458533,0,0,0
2012-07-23,1.28,419050,534580,953630,0,0,0
2012-07-24,1.5,438193,656167,1094360,0,0,0
2012-07-25,1.86,342568,635887,978455,0,0,0
2012-07-26,1.53,432099,662876,1094975,0,0,0
2012-07-27,1.3,709082,921619,1630701,0,0,0
2012-07-30,1.23,345762,425562,771324,0,0,0
2012-07-31,1.23,306692,378612,685304,0,0,0
2012-08-01,1.25,531562,662786,1194348,0,0,0
2012-08-02,1.15,552790,634826,1187616,0,0,0
2012-08-03,0.99,689100,679313,1368413,0,0,0
2012-08-06,1.17,357084,418909,775993,0,0,0
2012-08-07,1.74,314181,546457,860638,0,0,0
2012-08-08,1.52,279211,424198,703409,0,0,0
2012-08-09,1.36,287338,392071,679409,0,0,0
2012-08-10,1.73,278942,481517,760459,0,0,0
2012-08-13,1.34,320442,428180,748622,0,0,0
2012-08-14,0.86,485225,418092,903317,0,0,0
2012-08-15,1.18,314362,370938,685300,0,0,0
2012-08-16,0.97,568910,553113,1122023,0,0,0
2012-08-17,1.18,498378,589815,1088193,0,0,0
2012-08-20,1.52,294563,447337,741900,0,0,0
2012-08-21,1.49,431067,641374,1072441,0,0,0
2012-08-22,1.62,415316,671023,1086339,0,0,0
2012-08-23,1.09,457615,497173,954788,0,0,0
2012-08-24,1.1,502387,551125,1053512,0,0,0
2012-08-27,1.12,266591,299200,565791,0,0,0
2012-08-28,1.22,208408,254505,462913,0,0,0
2012-08-29,1.71,244149,417921,662070,0,0,0
2012-08-30,1.31,403278,529909,933187,0,0,0
2012-08-31,0.97,528175,513696,1041871,0,0,0
2012-09-04,1.02,315652,321032,636684,0,0,0
2012-09-05,1.43,338341,482730,821071,0,0,0
2012-09-06,1.21,601720,729927,1331647,0,0,0
2012-09-07,0.89,681717,603915,1285632,0,0,0
2012-09-10,1.21,399947,483199,883146,0,0,0
2012-09-11,1.48,356999,528858,885857,0,0,0
2012-09-12,1.14,469118,535547,1004665,0,0,0
2012-09-13,1.01,1035401,1047314,2082715,0,0,0
2012-09-14,0.78,1095622,856697,1952319,0,0,0
2012-09-17,0.95,445273,424510,869783,0,0,0
2012-09-18,0.7,532918,374106,907024,0,0,0
2012-09-19,0.88,513925,449792,963717,0,0,0
2012-09-20,1.06,595693,634220,1229913,0,0,0
2012-09-21,1.02,700929,713180,1414109,0,0,0
2012-09-24,1.15,417980,482247,900227,0,0,0
2012-09-25,1.31,450244,591564,1041808,0,0,0
2012-09-26,1.02,618116,633315,1251431,0,0,0
2012-09-27,1.07,440470,470135,910605,0,0,0
2012-09-28,1.55,480013,745673,1225686,0,0,0
2012-10-01,1.19,370765,439796,810561,0,0,0
2012-10-02,0.75,497055,373946,871001,0,0,0
2012-10-03,1.14,338574,384594,723168,0,0,0
2012-10-04,0.95,491511,468050,959561,0,0,0
2012-10-05,1.49,391941,582316,974257,0,0,0
2012-10-08,1.51,165077,248535,413612,0,0,0
2012-10-09,1.67,304191,506882,811073,0,0,0
2012-10-10,1.58,365571,578377,943948,0,0,0
2012-10-11,1.31,294048,383750,677798,0,0,0
2012-10-12,1.46,321406,468074,789480,0,0,0
2012-10-15,1.31,245260,321538,566798,0,0,0
2012-10-16,1.32,330453,436730,767183,0,0,0
2012-10-17,1.27,359583,455514,815097,0,0,0
2012-10-18,1.39,422367,588690,1011057,0,0,0
2012-10-19,1.44,791608,1137406,1929014,0,0,0
2012-10-22,1.48,313589,465637,779226,0,0,0
2012-10-23,1.83,421382,771081,1192463,0,0,0
2012-10-24,1.39,305641,426090,731731,0,0,0
2012-10-25,1.55,362347,560791,923138,0,0,0
2012-10-26,1.18,441590,523057,964647,0,0,0
2012-10-31,1.17,366881,429316,796197,0,0,0
2012-11-01,1.44,372030,536156,908186,0,0,0
2012-11-02,1.57,440561,690352,1130913,0,0,0
2012-11-05,1.1,373873,409622,783495,0,0,0
2012-11-06,1.47,461595,677328,1138923,0,0,0
2012-11-07,2.22,558674,1240264,1798938,0,0,0
2012-11-08,1.63,506322,826092,1332414,0,0,0
2012-11-09,1.39,487288,675360,1162648,0,0,0
2012-11-12,1.61,267472,431328,698800,0,0,0
2012-11-13,1.66,344461,572007,916468,0,0,0
2012-11-14,1.49,580278,865425,1445703,0,0,0
2012-11-15,1.71,573278,978453,1551731,0,0,0
2012-11-16,1.37,766614,1050485,1817099,0,0,0
2012-11-19,1.16,404325,468368,872693,0,0,0
2012-11-20,1.26,306978,387702,694680,0,0,0
2012-11-21,1.14,299233,340931,640164,0,0,0
2012-11-23,1.13,294431,331928,626359,0,0,0
2012-11-26,1.16,310873,359722,670595,0,0,0
2012-11-27,1.24,271491,336631,608122,0,0,0
2012-11-28,1.38,396403,547874,944277,0,0,0
2012-11-29,1.46,485790,709241,1195031,0,0,0
2012-11-30,1.85,364729,673821,1038550,0,0,0
2012-12-03,1.35,329994,445860,775854,0,0,0
2012-12-04,1.75,218405,383271,601676,0,0,0
2012-12-05,1.74,284484,493665,778149,0,0,0
2012-12-06,1.12,281810,316441,598251,0,0,0
2012-12-07,1.38,316497,435561,752058,0,0,0
2012-12-10,1.5,217226,325447,542673,0,0,0
2012-12-11,1.69,313511,531137,844648,0,0,0
2012-12-12,0.94,399893,375767,775660,0,0,0
2012-12-13,1.19,329376,392043,721419,0,0,0
2012-12-14,1.08,369085,397569,766654,0,0,0
2012-12-17,0.83,431952,359329,791281,0,0,0
2012-12-18,1.28,603131,773677,1376808,0,0,0
2012-12-19,1.49,438616,652202,1090818,0,0,0
2012-12-20,0.8,691318,555482,1246800,0,0,0
2012-12-21,1.18,673701,794819,1468520,0,0,0
2012-12-24,1.16,168901,195876,364777,0,0,0
2012-12-26,0.99,393203,390884,784087,0,0,0
2012-12-27,1.54,383662,589655,973317,0,0,0
2012-12-28,1.51,427306,643159,1070465,0,0,0
2012-12-31,1.6,517703,826815,1344518,0,0,0
2013-01-02,1.47,490690,719530,1210220,0,0,0
2013-01-03,1.25,394253,491066,885319,0,0,0
2013-01-04,1.46,326920,477610,804530,0,0,0
2013-01-07,1.1,222251,243424,465675,0,0,0
2013-01-08,1.75,223996,391220,615216,0,0,0
2013-01-09,1.6,171868,274645,446513,0,0,0
2013-01-10,1.41,292179,412151,704330,0,0,0
2013-01-11,1.68,272528,458687,731215,0,0,0
2013-01-14,1.63,221967,360989,582956,0,0,0
2013-01-15,1.75,252679,443388,696067,0,0,0
2013-01-16,1.4,204785,286514,491299,0,0,0
2013-01-17,1.08,427583,459725,887308,0,0,0
2013-01-18,1.17,519680,609899,1129579,0,0,0
2013-01-22,1.41,223779,316387,540166,0,0,0
2013-01-23,1.43,319857,456811,776668,0,0,0
2013-01-24,1.61,403803,650680,1054483,0,0,0
2013-01-25,1.36,390741,533044,923785,0,0,0
2013-01-28,1.63,237925,387956,625881,0,0,0
2013-01-29,1.53,258975,395808,654783,0,0,0
2013-01-30,1.39,273686,381644,655330,0,0,0
2013-01-31,1.93,262958,508206,771164,0,0,0
2013-02-01,1.19,551655,657649,1209304,0,0,0
2013-02-04,1.73,279900,483084,762984,0,0,0
2013-02-05,2.54,199646,507087,706733,0,0,0
2013-02-06,1.84,224214,413354,637568,0,0,0
2013-02-07,1.71,285267,487395,772662,0,0,0
2013-02-08,1.34,319407,429286,748693,0,0,0
2013-02-11,2.32,236654,549912,786566,0,0,0
2013-02-12,1.69,257227,435702,692929,0,0,0
2013-02-13,2.36,253884,599924,853808,0,0,0
2013-02-14,1.74,313736,544740,858476,0,0,0
2013-02-15,1.17,578330,677377,1255707,0,0,0
2013-02-19,1.79,248600,445313,693913,0,0,0
2013-02-20,1.98,427140,845992,1273132,0,0,0
2013-02-21,1.72,470149,807568,1277717,0,0,0
2013-02-22,1.14,423794,483996,907790,0,0,0
2013-02-25,1.74,557450,969311,1526761,0,0,0
2013-02-26,2.4,442334,1063000,1505334,0,0,0
2013-02-27,1.35,366548,495974,862522,0,0,0
2013-02-28,1.59,309627,492361,801988,0,0,0
2013-03-01,1.89,412150,780812,1192962,0,0,0
2013-03-04,1.81,225525,408824,634349,0,0,0
2013-03-05,2.16,411452,888123,1299575,0,0,0
2013-03-06,1.22,380068,464586,844654,0,0,0
2013-03-07,1.02,474855,482554,957409,0,0,0
2013-03-08,1.35,555420,747426,1302846,0,0,0
2013-03-11,1.28,359879,459727,819606,0,0,0
2013-03-12,2.12,372445,789202,1161647,0,0,0
2013-03-13,1.37,297541,407545,705086,0,0,0
2013-03-14,0.91,474031,429913,903944,0,0,0
2013-03-15,1.15,605531,698745,1304276,0,0,0
2013-03-18,1.55,372183,576470,948653,0,0,0
2013-03-19,1.87,452304,845063,1297367,0,0,0
2013-03-20,1.62,346002,558797,904799,0,0,0
2013-03-21,1.68,336091,565243,901334,0,0,0
2013-03-22,1.63,355785,580269,936054,0,0,0
2013-03-25,1.52,425202,645640,1070842,0,0,0
2013-03-26,1.26,265560,333577,599137,0,0,0
2013-03-27,1.98,275763,547275,823038,0,0,0
2013-03-28,1.37,342549,468466,811015,0,0,0
2013-04-01,1.96,268577,527512,796089,0,0,0
2013-04-02,1.89,261248,493689,754937,0,0,0
2013-04-03,1.7,479997,814109,1294106,0,0,0
2013-04-04,1.56,465965,728698,1194663,0,0,0
2013-04-05,1.62,539811,875840,1415651,0,0,0
2013-04-08,1.68,314324,528640,842964,0,0,0
2013-04-09,1.35,391774,527039,918813,0,0,0
2013-04-10,1.39,628043,872752,1500795,0,0,0
2013-04-11,1.51,483394,729294,1212688,0,0,0
2013-04-12,1.98,444289,880896,1325185,0,0,0
2013-04-15,2.01,690451,1387929,2078380,0,0,0
2013-04-16,1.88,394733,744046,1138779,0,0,0
2013-04-17,1.97,611566,1206398,1817964,0,0,0
2013-04-18,1.8,556354,1002710,1559064,0,0,0
2013-04-19,1.45,638155,927684,1565839,0,0,0
2013-04-22,1.86,330529,614200,944729,0,0,0
2013-04-23,1.35,416863,564624,981487,0,0,0
2013-04-24,1.52,311791,473540,785331,0,0,0
2013-04-25,0.93,91251,84592,175843,0,0,0
2013-04-26,1.15,468398,538609,1007007,0,0,0
2013-04-29,1.51,329842,497406,827248,0,0,0
2013-04-30,1.73,320882,555939,876821,0,0,0
2013-05-01,1.64,409255,670931,1080186,0,0,0
2013-05-02,1.72,319383,549277,868660,0,0,0
2013-05-03,1.34,614953,821460,1436413,0,0,0
2013-05-06,1.31,312252,407508,719760,0,0,0
2013-05-07,1.22,345826,423353,769179,0,0,0
2013-05-08,1.36,412974,560152,973126,0,0,0
2013-05-09,2.11,363669,766719,1130388,0,0,0
2013-05-10,1.17,595996,699504,1295500,0,0,0
2013-05-13,1.43,292129,418811,710940,0,0,0
2013-05-14,1.09,581687,632769,1214456,0,0,0
2013-05-15,1.48,578479,855060,1433539,0,0,0
2013-05-16,1.45,511000,738841,1249841,0,0,0
2013-05-17,1.12,772208,864596,1636804,0,0,0
2013-05-20,1.23,430630,531676,962306,0,0,0
2013-05-21,1.94,289830,561048,850878,0,0,0
2013-05-22,1.63,742549,1212948,1955497,0,0,0
2013-05-23,1.59,521315,829685,1351000,0,0,0
2013-05-24,1.6,455159,726968,1182127,0,0,0
2013-05-28,1.57,476764,750472,1227236,0,0,0
2013-05-29,1.76,340473,598619,939092,0,0,0
2013-05-30,1.67,379491,632822,1012313,0,0,0
2013-05-31,1.86,462440,859309,1321749,0,0,0
2013-06-03,1.35,616938,830996,1447934,0,0,0
2013-06-04,1.98,386987,767457,1154444,0,0,0
2013-06-05,1.73,586083,1012943,1599026,0,0,0
2013-06-06,1.61,685063,1102757,1787820,0,0,0
2013-06-07,1.76,596851,1049971,1646822,0,0,0
2013-06-10,2.18,335547,729925,1065472,0,0,0
2013-06-11,1.92,386332,741971,1128303,0,0,0
2013-06-12,1.8,574297,1036316,1610613,0,0,0
2013-06-13,1.24,545476,676927,1222403,0,0,0
2013-06-14,1.76,455254,799635,1254889,0,0,0
2013-06-17,1.54,343286,527741,871027,0,0,0
2013-06-18,1.56,445617,694765,1140382,0,0,0
2013-06-19,1.65,644318,1060355,1704673,0,0,0
2013-06-20,2.04,1105317,2251738,3357055,0,0,0
2013-06-21,1.58,960254,1519398,2479652,0,0,0
2013-06-24,1.26,729648,921349,1650997,0,0,0
2013-06-25,1.58,384452,607443,991895,0,0,0
2013-06-26,1.23,479298,589386,1068684,0,0,0
2013-06-27,1.27,598360,759858,1358218,0,0,0
2013-06-28,1.17,579181,674777,1253958,0,0,0
2013-07-01,1.33,390329,519335,909664,0,0,0
2013-07-02,1.62,395728,640821,1036549,0,0,0
2013-07-03,1.48,265971,394260,660231,0,0,0
2013-07-05,1.15,652786,752600,1405386,0,0,0
2013-07-08,1.92,335441,644043,979484,0,0,0
2013-07-09,2.34,400090,934212,1334302,0,0,0
2013-07-10,1.97,462939,912343,1375282,0,0,0
2013-07-11,1.38,630750,872338,1503088,0,0,0
2013-07-12,1.72,458789,789626,1248415,0,0,0
2013-07-15,1.46,330870,484603,815473,0,0,0
2013-07-16,1.65,380069,626737,1006806,0,0,0
2013-07-17,1.55,384821,596241,981062,0,0,0
2013-07-18,1.12,531473,596786,1128259,0,0,0
2013-07-19,1.4,461727,648188,1109915,0,0,0
2013-07-22,1.28,359790,459493,819283,0,0,0
2013-07-23,1.69,339368,572713,912081,0,0,0
2013-07-24,1.6,375719,601652,977371,0,0,0
2013-07-25,2.03,300012,609449,909461,0,0,0
2013-07-26,1.35,411483,554754,966237,0,0,0
2013-07-29,1.21,256271,309982,566253,0,0,0
2013-07-30,1.44,285817,412897,698714,0,0,0
2013-07-31,1.32,506349,667130,1173479,0,0,0
2013-08-01,1.21,542667,655667,1198334,0,0,0
2013-08-02,1.14,480807,547574,1028381,0,0,0
2013-08-05,1.46,252625,368226,620851,0,0,0
2013-08-06,3.22,309673,997489,1307162,0,0,0
2013-08-07,1.79,316816,568310,885126,0,0,0
2013-08-08,1.14,415229,472671,887900,0,0,0
2013-08-09,1.46,379039,553637,932676,0,0,0
2013-08-12,1.46,304805,443625,748430,0,0,0
2013-08-13,1.5,356748,534266,891014,0,0,0
2013-08-14,1.51,338426,512209,850635,0,0,0
2013-08-15,1.49,829544,1235182,2064726,0,0,0
2013-08-16,1.47,697250,1026780,1724030,0,0,0
2013-08-19,1.39,362088,503933,866021,0,0,0
2013-08-20,2.02,361773,729710,1091483,0,0,0
2013-08-21,1.64,478035,783832,1261867,0,0,0
2013-08-22,1.17,344535,403410,747945,0,0,0
2013-08-23,0.94,485032,456259,941291,0,0,0
2013-08-26,1.45,334614,483742,818356,0,0,0
2013-08-27,1.24,641632,796058,1437690,0,0,0
2013-08-28,1.01,439105,443684,882789,0,0,0
2013-08-29,1.56,376552,586594,963146,0,0,0
2013-08-30,1.76,469674,827520,1297194,0,0,0
2013-09-03,1.16,342205,398430,740635,0,0,0
2013-09-04,1.61,281418,451770,733188,0,0,0
2013-09-05,1.28,344356,440575,784931,0,0,0
2013-09-06,1.35,510528,690295,1200823,0,0,0
2013-09-09,1.27,389637,493576,883213,0,0,0
2013-09-10,1.67,461453,768420,1229873,0,0,0
2013-09-11,1.44,320623,460995,781618,0,0,0
2013-09-12,1.47,408432,599418,1007850,0,0,0
2013-09-13,1.09,462797,506640,969437,0,0,0
2013-09-16,1.54,397789,611723,1009512,0,0,0
2013-09-17,1.21,378566,456469,835035,0,0,0
2013-09-18,1.12,1119098,1255304,2374402,0,0,0
2013-09-19,1.09,738168,806360,1544528,0,0,0
2013-09-20,2.1,473066,991538,1464604,0,0,0
2013-09-23,1.43,336065,479753,815818,0,0,0
2013-09-24,1.74,257103,447661,704764,0,0,0
2013-09-25,1.76,285914,503406,789320,0,0,0
2013-09-26,1.26,322757,407692,730449,0,0,0
2013-09-27,1.38,524716,726042,1250758,0,0,0
2013-09-30,1.87,440968,825860,1266828,0,0,0
2013-10-01,1.66,323081,536528,859609,0,0,0
2013-10-02,1.17,369871,431716,801587,0,0,0
2013-10-03,1.51,691130,1042385,1733515,0,0,0
2013-10-04,1.15,441616,507836,949452,0,0,0
2013-10-07,1.48,437912,649303,1087215,0,0,0
2013-10-08,1.67,644129,1073830,1717959,0,0,0
2013-10-09,2.87,595755,1712424,2308179,0,0,0
2013-10-10,1.47,608052,891019,1499071,0,0,0
2013-10-11,1.51,500304,756248,1256552,0,0,0
2013-10-14,1.36,392818,535743,928561,0,0,0
2013-10-15,2.35,368927,867299,1236226,0,0,0
2013-10-16,1.53,538877,826913,1365790,0,0,0
2013-10-17,1.3,746845,969289,1716134,0,0,0
2013-10-18,1.03,717656,742233,1459889,0,0,0
2013-10-21,1.5,313499,471058,784557,0,0,0
2013-10-22,1.46,488372,710602,1198974,0,0,0
2013-10-23,1.5,277808,415583,693391,0,0,0
2013-10-24,1.29,338836,436260,775096,0,0,0
2013-10-25,1.52,365915,554891,920806,0,0,0
2013-10-28,1.15,310173,355777,665950,0,0,0
2013-10-29,1.18,328053,388242,716295,0,0,0
2013-10-30,2.06,387720,797291,1185011,0,0,0
2013-10-31,1.55,321911,498080,819991,0,0,0
2013-11-01,1.67,398010,664370,1062380,0,0,0
2013-11-04,1.55,283428,440140,723568,0,0,0
2013-11-05,1.94,238149,462453,700602,0,0,0
2013-11-06,1.94,284061,551438,835499,0,0,0
2013-11-07,1.99,568759,1131917,1700676,0,0,0
2013-11-08,1.35,655460,882475,1537935,0,0,0
2013-11-11,2.2,179479,394101,573580,0,0,0
2013-11-12,1.48,387859,573518,961377,0,0,0
2013-11-13,1.58,389886,616187,1006073,0,0,0
2013-11-14,1.07,593007,632648,1225655,0,0,0
2013-11-15,0.92,595325,546052,1141377,0,0,0
2013-11-18,1.12,462048,516688,978736,0,0,0
2013-11-19,1.46,384214,562133,946347,0,0,0
2013-11-20,1.55,381057,590110,971167,0,0,0
2013-11-21,1.42,326562,463627,790189,0,0,0
2013-11-22,1.23,392621,482872,875493,0,0,0
2013-11-25,1.0,340828,342011,682839,0,0,0
2013-11-26,1.3,326106,425257,751363,0,0,0
2013-11-27,1.36,277341,376042,653383,0,0,0
2013-11-29,1.07,212909,228092,441001,0,0,0
2013-12-02,1.22,362153,441687,803840,0,0,0
2013-12-03,1.39,366558,510287,876845,0,0,0
2013-12-04,1.33,375031,500634,875665,0,0,0
2013-12-05,1.08,377822,408721,786543,0,0,0
2013-12-06,1.21,479288,579449,1058737,0,0,0
2013-12-09,1.45,255812,370562,626374,0,0,0
2013-12-10,0.85,339517,287794,627311,0,0,0
2013-12-11,1.37,487661,670197,1157858,0,0,0
2013-12-12,0.99,532424,527110,1059534,0,0,0
2013-12-13,0.83,504816,419893,924709,0,0,0
2013-12-16,1.57,274719,431791,706510,0,0,0
2013-12-17,1.45,416694,602126,1018820,0,0,0
2013-12-18,1.03,804871,825634,1630505,0,0,0
2013-12-19,1.02,611952,625225,1237177,0,0,0
2013-12-20,0.77,918216,709064,1627280,0,0,0
2013-12-23,0.74,491457,363252,854709,0,0,0
2013-12-24,0.83,264984,219605,484589,0,0,0
2013-12-26,0.64,492786,317728,810514,0,0,0
2013-12-27,1.29,318463,412389,730852,0,0,0
2013-12-30,1.42,329888,466799,796687,0,0,0
2013-12-31,0.93,508010,474750,982760,0,0,0
2014-01-02,0.79,558659,442877,1001536,0,0,0
2014-01-03,1.29,391318,503356,894674,0,0,0
2014-01-06,1.26,324385,409093,733478,0,0,0
2014-01-07,1.35,317162,427440,744602,0,0,0
2014-01-08,1.02,397603,407347,804950,0,0,0
2014-01-09,1.33,388877,517392,906269,0,0,0
2014-01-10,1.31,455955,596183,1052138,0,0,0
2014-01-13,1.17,470103,548053,1018156,0,0,0
2014-01-14,1.25,341921,426408,768329,0,0,0
2014-01-15,1.47,635745,932823,1568568,0,0,0
2014-01-16,1.42,400790,569901,970691,0,0,0
2014-01-17,1.27,535621,681687,1217308,0,0,0
2014-01-21,1.51,286313,431610,717923,0,0,0
2014-01-22,1.42,272163,385448,657611,0,0,0
2014-01-23,1.45,489709,709569,1199278,0,0,0
2014-01-24,1.34,853892,1140541,1994433,0,0,0
2014-01-27,1.52,644747,978120,1622867,0,0,0
2014-01-28,1.4,422338,590412,1012750,0,0,0
2014-01-29,1.31,630020,828305,1458325,0,0,0
2014-01-30,1.1,639315,706060,1345375,0,0,0
2014-01-31,1.69,621400,1051739,1673139,0,0,0
2014-02-03,1.34,996297,1334312,2330609,0,0,0
2014-02-04,1.48,619475,918406,1537881,0,0,0
2014-02-05,1.65,597017,986527,1583544,0,0,0
2014-02-06,1.53,530935,814623,1345558,0,0,0
2014-02-07,1.24,728706,900936,1629642,0,0,0
2014-02-10,1.44,338338,487609,825947,0,0,0
2014-02-11,1.02,669996,682141,1352137,0,0,0
2014-02-12,1.12,488614,549400,1038014,0,0,0
2014-02-13,1.1,539782,591633,1131415,0,0,0
2014-02-14,1.02,720256,737076,1457332,0,0,0
2014-02-18,1.12,457798,514927,972725,0,0,0
2014-02-19,1.56,671858,1046284,1718142,0,0,0
2014-02-20,1.66,440674,732523,1173197,0,0,0
2014-02-21,0.87,673625,588666,1262291,0,0,0
2014-02-24,1.18,614200,722937,1337137,0,0,0
2014-02-25,1.73,364380,631763,996143,0,0,0
2014-02-26,1.64,401085,658247,1059332,0,0,0
2014-02-27,1.59,369883,588642,958525,0,0,0
2014-02-28,1.12,668966,750574,1419540,0,0,0
2014-03-03,1.78,421135,748566,1169701,0,0,0
2014-03-04,1.32,513418,676134,1189552,0,0,0
2014-03-05,1.41,265322,373874,639196,0,0,0
2014-03-06,1.06,670533,712616,1383149,0,0,0
2014-03-07,1.31,511945,669029,1180974,0,0,0
2014-03-10,1.77,298946,528693,827639,0,0,0
2014-03-11,1.63,333098,542543,875641,0,0,0
2014-03-12,1.45,424370,614700,1039070,0,0,0
2014-03-13,2.1,565103,1186886,1751989,0,0,0
2014-03-14,1.59,623864,995016,1618880,0,0,0
2014-03-17,1.52,407314,619331,1026645,0,0,0
2014-03-18,1.5,383365,575747,959112,0,0,0
2014-03-19,1.47,473877,695990,1169867,0,0,0
2014-03-20,0.78,737107,574391,1311498,0,0,0
2014-03-21,1.36,627158,852489,1479647,0,0,0
2014-03-24,1.49,433009,647344,1080353,0,0,0
2014-03-25,1.36,325027,442982,768009,0,0,0
2014-03-26,1.9,411094,781219,1192313,0,0,0
2014-03-27,1.16,519894,601006,1120900,0,0,0
2014-03-28,1.76,421695,743657,1165352,0,0,0
2014-03-31,2.17,309340,672339,981679,0,0,0
2014-04-01,1.53,380480,583650,964130,0,0,0
2014-04-02,1.19,367883,439221,807104,0,0,0
2014-04-03,1.49,357175,531618,888793,0,0,0
2014-04-04,1.63,801405,1309376,2110781,0,0,0
2014-04-07,2.09,437072,913064,1350136,0,0,0
2014-04-08,1.68,405641,679619,1085260,0,0,0
2014-04-09,0.61,1105688,678299,1783987,0,0,0
2014-04-10,1.82,623788,1132926,1756714,0,0,0
2014-04-11,2.09,666612,1395363,2061975,0,0,0
2014-04-14,1.52,437682,663774,1101456,0,0,0
2014-04-15,1.96,567105,1112952,1680057,0,0,0
2014-04-16,1.62,542084,876854,1418938,0,0,0
2014-04-17,1.27,755567,960573,1716140,0,0,0
2014-04-21,1.51,264385,398832,663217,0,0,0
2014-04-22,1.6,342060,548112,890172,0,0,0
2014-04-23,2.25,226907,511030,737937,0,0,0
2014-04-24,1.0,443415,441845,885260,0,0,0
2014-04-25,2.11,445000,939387,1384387,0,0,0
2014-04-28,1.66,353710,588033,941743,0,0,0
2014-04-29,1.75,291281,510022,801303,0,0,0
2014-04-30,1.71,305027,521650,826677,0,0,0
2014-05-01,1.79,310908,557597,868505,0,0,0
2014-05-02,1.51,510685,769901,1280586,0,0,0
2014-05-05,1.34,279798,374654,654452,0,0,0
2014-05-06,2.08,279881,582098,861979,0,0,0
2014-05-07,1.45,484111,701014,1185125,0,0,0
2014-05-08,1.79,387843,695531,1083374,0,0,0
2014-05-09,1.83,381334,698531,1079865,0,0,0
2014-05-12,1.89,381962,720135,1102097,0,0,0
2014-05-13,1.54,385526,592717,978243,0,0,0
2014-05-14,1.64,338074,555845,893919,0,0,0
2014-05-15,1.46,725928,1059207,1785135,0,0,0
2014-05-16,1.33,532907,707842,1240749,0,0,0
2014-05-19,1.26,318526,401982,720508,0,0,0
2014-05-20,1.56,263593,410726,674319,0,0,0
2014-05-21,2.04,335572,684411,1019983,0,0,0
2014-05-22,1.26,374472,473369,847841,0,0,0
2014-05-23,1.36,448030,608398,1056428,0,0,0
2014-05-27,0.84,702210,589918,1292128,0,0,0
2014-05-28,1.82,288071,524230,812301,0,0,0
2014-05-29,1.16,415736,480931,896667,0,0,0
2014-05-30,1.54,479854,740790,1220644,0,0,0
2014-06-02,0.52,812952,421375,1234327,0,0,0
2014-06-03,1.33,340685,452802,793487,0,0,0
2014-06-04,1.51,486524,735936,1222460,0,0,0
2014-06-05,1.25,572469,715660,1288129,0,0,0
2014-06-06,1.66,587226,977717,1564943,0,0,0
2014-06-09,1.53,432390,660661,1093051,0,0,0
2014-06-10,1.19,341743,406039,747782,0,0,0
2014-06-11,1.43,282951,405485,688436,0,0,0
2014-06-12,1.71,420308,720371,1140679,0,0,0
2014-06-13,1.79,330483,592958,923441,0,0,0
2014-06-16,1.26,313793,395127,708920,0,0,0
2014-06-17,1.28,496758,637165,1133923,0,0,0
2014-06-18,1.54,441633,681928,1123561,0,0,0
2014-06-19,0.72,776714,559322,1336036,0,0,0
2014-06-20,1.46,537535,782486,1320021,0,0,0
2014-06-23,2.02,257256,520166,777422,0,0,0
2014-06-24,1.78,369610,657991,1027601,0,0,0
2014-06-25,2.0,253689,507955,761644,0,0,0
2014-06-26,1.92,277158,531014,808172,0,0,0
2014-06-27,1.24,328947,406403,735350,0,0,0
2014-06-30,1.3,306036,396599,702635,0,0,0
2014-07-01,1.92,384326,739058,1123384,0,0,0
2014-07-02,1.5,350841,526451,877292,0,0,0
2014-07-03,1.81,330534,598640,929174,0,0,0
2014-07-07,2.14,234658,502371,737029,0,0,0
2014-07-08,2.19,390462,855036,1245498,0,0,0
2014-07-09,1.35,349126,470886,820012,0,0,0
2014-07-10,2.07,379499,787309,1166808,0,0,0
2014-07-11,1.27,393174,501025,894199,0,0,0
2014-07-14,1.77,271571,479326,750897,0,0,0
2014-07-15,1.43,416868,597968,1014836,0,0,0
2014-07-16,1.57,281902,443982,725884,0,0,0
2014-07-17,2.37,541326,1281439,1822765,0,0,0
2014-07-18,1.61,556881,894531,1451412,0,0,0
2014-07-21,1.64,265387,434612,699999,0,0,0
2014-07-22,1.71,401871,688222,1090093,0,0,0
2014-07-23,1.28,296634,379896,676530,0,0,0
2014-07-24,1.33,309718,413198,722916,0,0,0
2014-07-25,1.27,396993,503228,900221,0,0,0
2014-07-28,1.69,327825,554492,882317,0,0,0
2014-07-29,1.48,313065,464770,777835,0,0,0
2014-07-30,2.28,435139,992809,1427948,0,0,0
2014-07-31,2.41,652642,1570877,2223519,0,0,0
2014-08-01,1.83,669230,1222016,1891246,0,0,0
2014-08-04,1.89,323613,611829,935442,0,0,0
2014-08-05,2.26,370048,837816,1207864,0,0,0
2014-08-06,1.69,430989,728969,1159958,0,0,0
2014-08-07,1.43,478397,683073,1161470,0,0,0
2014-08-08,1.59,463720,737971,1201691,0,0,0
2014-08-11,1.51,364164,548268,912432,0,0,0
2014-08-12,1.93,244864,473317,718181,0,0,0
2014-08-13,1.79,392911,703197,1096108,0,0,0
2014-08-14,1.68,294254,495444,789698,0,0,0
2014-08-15,1.43,746608,1070173,1816781,0,0,0
2014-08-18,1.69,373695,630774,1004469,0,0,0
2014-08-19,2.03,298432,605502,903934,0,0,0
2014-08-20,2.16,266950,576318,843268,0,0,0
2014-08-21,1.11,402363,445124,847487,0,0,0
2014-08-22,2.15,318516,683745,1002261,0,0,0
2014-08-25,1.69,268855,453413,722268,0,0,0
2014-08-26,1.58,258068,408491,666559,0,0,0
2014-08-27,1.53,323516,496548,820064,0,0,0
2014-08-28,3.9,221955,866576,1088531,0,0,0
2014-08-29,1.25,425807,533778,959585,0,0,0
2014-09-02,1.77,297926,526660,824586,0,0,0
2014-09-03,2.4,262457,630949,893406,0,0,0
2014-09-04,1.94,417597,808403,1226000,0,0,0
2014-09-05,1.8,439933,793931,1233864,0,0,0
2014-09-08,1.35,365998,493041,859039,0,0,0
2014-09-09,1.57,383755,603756,987511,0,0,0
2014-09-10,1.85,357641,660543,1018184,0,0,0
2014-09-11,1.98,364481,723420,1087901,0,0,0
2014-09-12,1.61,535696,864786,1400482,0,0,0
2014-09-15,1.69,331512,560309,891821,0,0,0
2014-09-16,1.57,469106,735088,1204194,0,0,0
2014-09-17,1.66,584683,970571,1555254,0,0,0
2014-09-18,1.41,555136,782051,1337187,0,0,0
2014-09-19,1.71,590421,1008476,1598897,0,0,0
2014-09-22,1.91,426670,814386,1241056,0,0,0
2014-09-23,1.72,442788,760464,1203252,0,0,0
2014-09-24,1.61,432581,696916,1129497,0,0,0
2014-09-25,2.32,483297,1122412,1605709,0,0,0
2014-09-26,2.5,428263,1068934,1497197,0,0,0
2014-09-29,1.89,412286,779137,1191423,0,0,0
2014-09-30,1.91,468974,896692,1365666,0,0,0
2014-10-01,2.16,627355,1353833,1981188,0,0,0
2014-10-02,1.8,677195,1220251,1897446,0,0,0
2014-10-03,1.64,547664,898261,1445925,0,0,0
2014-10-06,1.47,399303,586119,985422,0,0,0
2014-10-07,1.55,537396,835463,1372859,0,0,0
2014-10-08,1.32,915001,1210686,2125687,0,0,0
2014-10-09,1.36,1090929,1480290,2571219,0,0,0
2014-10-10,2.01,820857,1651557,2472414,0,0,0
2014-10-13,2.54,779997,1978568,2758565,0,0,0
2014-10-14,2.0,660808,1324233,1985041,0,0,0
2014-10-15,2.18,1000491,2176968,3177459,0,0,0
2014-10-16,1.83,709137,1297019,2006156,0,0,0
2014-10-17,1.63,830389,1355683,2186072,0,0,0
2014-10-20,1.11,522497,579408,1101905,0,0,0
2014-10-21,1.21,835831,1011546,1847377,0,0,0
2014-10-22,1.45,790692,1146527,1937219,0,0,0
2014-10-23,1.24,793392,982997,1776389,0,0,0
2014-10-24,1.34,641170,861454,1502624,0,0,0
2014-10-27,1.18,499473,591357,1090830,0,0,0
2014-10-28,1.62,456675,739208,1195883,0,0,0
2014-10-29,1.55,491883,759980,1251863,0,0,0
2014-10-30,1.75,414862,727769,1142631,0,0,0
2014-10-31,1.0,882621,883193,1765814,0,0,0
2014-11-03,1.06,443015,469037,912052,0,0,0
2014-11-04,1.27,385057,488947,874004,0,0,0
2014-11-05,1.4,326296,458368,784664,0,0,0
2014-11-06,1.12,528323,590167,1118490,0,0,0
2014-11-07,1.57,400855,629061,1029916,0,0,0
2014-11-10,1.86,336716,627730,964446,0,0,0
2014-11-11,2.11,264690,557658,822348,0,0,0
2014-11-12,1.37,298003,407485,705488,0,0,0
2014-11-13,1.71,357487,612371,969858,0,0,0
2014-11-14,1.61,374954,605273,980227,0,0,0
2014-11-17,1.42,268017,381397,649414,0,0,0
2014-11-18,1.07,531492,567914,1099406,0,0,0
2014-11-19,1.62,384388,621811,1006199,0,0,0
2014-11-20,1.43,374465,536592,911057,0,0,0
2014-11-21,0.93,866670,804590,1671260,0,0,0
2014-11-24,1.0,414516,415449,829965,0,0,0
2014-11-25,1.84,280472,516964,797436,0,0,0
2014-11-26,0.93,385992,357493,743485,0,0,0
2014-11-28,1.44,325124,468438,793562,0,0,0
2014-12-01,1.58,438336,692225,1130561,0,0,0
2014-12-02,1.87,251707,470406,722113,0,0,0
2014-12-03,1.18,284361,335268,619629,0,0,0
2014-12-04,1.65,311370,514396,825766,0,0,0
2014-12-05,1.62,397582,644961,1042543,0,0,0
2014-12-08,1.66,418616,693382,1111998,0,0,0
2014-12-09,1.44,458154,660399,1118553,0,0,0
2014-12-10,1.28,718249,919790,1638039,0,0,0
2014-12-11,1.62,524087,850993,1375080,0,0,0
2014-12-12,1.84,627688,1153429,1781117,0,0,0
2014-12-15,1.26,1062082,1338462,2400544,0,0,0
2014-12-16,1.61,679191,1093069,1772260,0,0,0
2014-12-17,1.63,761088,1237720,1998808,0,0,0
2014-12-18,0.93,994268,919961,1914229,0,0,0
2014-12-19,1.01,715104,720328,1435432,0,0,0
2014-12-22,1.15,358155,411224,769379,0,0,0
2014-12-23,1.36,324406,442549,766955,0,0,0
2014-12-24,1.07,223357,239610,462967,0,0,0
2014-12-26,0.82,471574,386567,858141,0,0,0
2014-12-29,1.1,331659,365106,696765,0,0,0
2014-12-30,1.13,293142,332581,625723,0,0,0
2014-12-31,1.26,505524,638280,1143804,0,0,0
2015-01-02,1.37,510202,699012,1209214,0,0,0
2015-01-05,1.67,612645,1022077,1634722,0,0,0
2015-01-06,1.56,632599,984393,1616992,0,0,0
2015-01-07,0.99,546639,543838,1090477,0,0,0
2015-01-08,1.11,629492,698776,1328268,0,0,0
2015-01-09,1.11,633420,700630,1334050,0,0,0
2015-01-12,1.52,387072,586984,974056,0,0,0
2015-01-13,1.2,652525,784967,1437492,0,0,0
2015-01-14,1.82,566764,1031776,1598540,0,0,0
2015-01-15,1.48,661690,982453,1644143,0,0,0
2015-01-16,1.0,858863,862874,1721737,0,0,0
2015-01-20,1.21,381985,463443,845428,0,0,0
2015-01-21,1.74,414166,720554,1134720,0,0,0
2015-01-22,1.37,631169,862524,1493693,0,0,0
2015-01-23,1.53,460360,704630,1164990,0,0,0
2015-01-26,1.31,315887,414474,730361,0,0,0
2015-01-27,1.68,390704,655597,1046301,0,0,0
2015-01-28,1.56,426442,665081,1091523,0,0,0
2015-01-29,1.54,518356,796442,1314798,0,0,0
2015-01-30,1.54,547776,846267,1394043,0,0,0
2015-02-02,1.33,416907,555158,972065,0,0,0
2015-02-03,1.34,472239,631327,1103566,0,0,0
2015-02-04,1.47,386158,566223,952381,0,0,0
2015-02-05,1.26,416776,524268,941044,0,0,0
2015-02-06,1.47,649292,957011,1606303,0,0,0
2015-02-09,1.5,289894,434172,724066,0,0,0
2015-02-10,1.19,413243,492739,905982,0,0,0
2015-02-11,1.69,318922,540403,859325,0,0,0
2015-02-12,1.01,624477,631852,1256329,0,0,0
2015-02-13,1.27,540731,684126,1224857,0,0,0
2015-02-17,1.33,393710,522441,916151,0,0,0
2015-02-18,1.44,394721,566473,961194,0,0,0
2015-02-19,1.5,372554,558711,931265,0,0,0
2015-02-20,0.98,710570,697696,1408266,0,0,0
2015-02-23,1.2,348265,417472,765737,0,0,0
2015-02-24,1.69,325061,548005,873066,0,0,0
2015-02-25,1.41,306195,430943,737138,0,0,0
2015-02-26,1.57,330302,518597,848899,0,0,0
2015-02-27,1.34,420495,562948,983443,0,0,0
2015-03-02,1.8,246949,444868,691817,0,0,0
2015-03-03,1.32,300694,396368,697062,0,0,0
2015-03-04,1.09,381990,417934,799924,0,0,0
2015-03-05,1.59,234700,373735,608435,0,0,0
2015-03-06,1.97,549194,1083394,1632588,0,0,0
2015-03-09,1.98,291454,577106,868560,0,0,0
2015-03-10,1.65,472169,779205,1251374,0,0,0
2015-03-11,1.7,342602,583279,925881,0,0,0
2015-03-12,1.72,295181,508608,803789,0,0,0
2015-03-13,1.57,482175,754793,1236968,0,0,0
2015-03-16,1.44,406317,583184,989501,0,0,0
2015-03-17,1.27,368760,469447,838207,0,0,0
2015-03-18,1.17,691428,810103,1501531,0,0,0
2015-03-19,1.23,478692,588637,1067329,0,0,0
2015-03-20,0.9,862726,774307,1637033,0,0,0
2015-03-23,1.31,328320,428544,756864,0,0,0
2015-03-24,1.97,239565,471473,711038,0,0,0
2015-03-25,1.5,465329,696545,1161874,0,0,0
2015-03-26,1.65,480272,793181,1273453,0,0,0
2015-03-27,1.44,337404,487349,824753,0,0,0
2015-03-30,1.14,426455,486078,912533,0,0,0
2015-03-31,1.62,410669,663926,1074595,0,0,0
2015-04-01,1.37,498063,681788,1179851,0,0,0
2015-04-02,1.36,402469,547377,949846,0,0,0
2015-04-06,1.31,394175,517428,911603,0,0,0
2015-04-07,1.63,291148,474527,765675,0,0,0
2015-04-08,1.45,376645,544703,921348,0,0,0
2015-04-09,1.29,408559,527042,935601,0,0,0
2015-04-10,1.59,408879,650340,1059219,0,0,0
2015-04-13,1.15,453247,521488,974735,0,0,0
2015-04-14,1.49,312689,464422,777111,0,0,0
2015-04-15,0.87,541756,469087,1010843,0,0,0
2015-04-16,0.93,485182,449632,934814,0,0,0
2015-04-17,1.46,682604,993239,1675843,0,0,0
2015-04-20,1.21,348477,421016,769493,0,0,0
2015-04-21,1.51,213251,321478,534729,0,0,0
2015-04-22,1.38,324247,447600,771847,0,0,0
2015-04-23,1.41,387863,546766,934629,0,0,0
2015-04-24,0.81,484029,391474,875503,0,0,0
2015-04-27,1.27,366812,467180,833992,0,0,0
2015-04-28,1.59,289470,458830,748300,0,0,0
2015-04-29,1.31,394702,515627,910329,0,0,0
2015-04-30,1.16,650380,755641,1406021,0,0,0
2015-05-01,1.27,374231,473613,847844,0,0,0
2015-05-04,1.36,249686,338388,588074,0,0,0
2015-05-05,1.88,497408,936648,1434056,0,0,0
2015-05-06,1.71,477967,818035,1296002,0,0,0
2015-05-07,1.7,333169,565558,898727,0,0,0
2015-05-08,1.44,547960,787904,1335864,0,0,0
2015-05-11,1.91,240221,458297,698518,0,0,0
2015-05-12,1.18,455972,538273,994245,0,0,0
2015-05-13,1.2,372196,447976,820172,0,0,0
2015-05-14,1.29,427250,549592,976842,0,0,0
2015-05-15,0.89,480163,428488,908651,0,0,0
2015-05-18,2.2,330042,726720,1056762,0,0,0
2015-05-19,1.47,303389,445073,748462,0,0,0
2015-05-20,1.29,272811,351417,624228,0,0,0
2015-05-21,1.4,306058,428661,734719,0,0,0
2015-05-22,1.4,314870,440357,755227,0,0,0
2015-05-26,1.71,392309,671293,1063602,0,0,0
2015-05-27,2.52,240095,604432,844527,0,0,0
2015-05-28,1.58,268732,423607,692339,0,0,0
2015-05-29,1.95,327457,638253,965710,0,0,0
2015-06-01,1.32,331348,437886,769234,0,0,0
2015-06-02,1.62,289005,468386,757391,0,0,0
2015-06-03,1.6,306915,492235,799150,0,0,0
2015-06-04,1.93,381553,736749,1118302,0,0,0
2015-06-05,1.3,489613,637261,1126874,0,0,0
2015-06-08,2.21,302910,668004,970914,0,0,0
2015-06-09,1.16,371286,432465,803751,0,0,0
2015-06-10,1.64,452503,744185,1196688,0,0,0
2015-06-11,1.27,398299,507771,906070,0,0,0
2015-06-12,1.44,417629,602211,1019840,0,0,0
2015-06-15,1.46,371239,541606,912845,0,0,0
2015-06-16,1.26,423287,534771,958058,0,0,0
2015-06-17,1.2,449258,540129,989387,0,0,0
2015-06-18,1.49,587987,877081,1465068,0,0,0
2015-06-19,1.26,514160,646644,1160804,0,0,0
2015-06-22,1.2,378669,455798,834467,0,0,0
2015-06-23,1.66,303965,505181,809146,0,0,0
2015-06-24,1.53,303645,464454,768099,0,0,0
2015-06-25,2.11,256205,540403,796608,0,0,0
2015-06-26,1.32,566766,750283,1317049,0,0,0
2015-06-29,1.85,630098,1165219,1795317,0,0,0
2015-06-30,1.42,505003,717746,1222749,0,0,0
2015-07-01,1.5,444172,668220,1112392,0,0,0
2015-07-02,1.49,500419,747585,1248004,0,0,0
2015-07-06,2.44,360576,880499,1241075,0,0,0
2015-07-07,2.05,535199,1094945,1630144,0,0,0
2015-07-08,1.78,508150,906528,1414678,0,0,0
2015-07-09,1.98,395856,783035,1178891,0,0,0
2015-07-10,1.37,468206,642096,1110302,0,0,0
2015-07-13,1.11,462787,515738,978525,0,0,0
2015-07-14,1.87,324679,606325,931004,0,0,0
2015-07-15,1.54,300376,463163,763539,0,0,0
2015-07-16,1.17,432639,506805,939444,0,0,0
2015-07-17,1.15,507162,583562,1090724,0,0,0
2015-07-20,1.31,394783,516698,911481,0,0,0
2015-07-21,1.04,359399,373415,732814,0,0,0
2015-07-22,2.23,215608,480138,695746,0,0,0
2015-07-23,1.54,539972,832464,1372436,0,0,0
2015-07-24,2.21,416402,921921,1338323,0,0,0
2015-07-27,2.25,370593,833586,1204179,0,0,0
2015-07-28,1.12,433651,486458,920109,0,0,0
2015-07-29,1.42,386349,548452,934801,0,0,0
2015-07-30,1.06,281697,298214,579911,0,0,0
2015-07-31,1.47,339438,498470,837908,0,0,0
2015-08-03,1.59,316939,502406,819345,0,0,0
2015-08-04,1.21,267518,322987,590505,0,0,0
2015-08-05,1.63,293693,479314,773007,0,0,0
2015-08-06,2.57,403742,1036850,1440592,0,0,0
2015-08-07,1.75,431205,754059,1185264,0,0,0
2015-08-10,1.56,279594,435291,714885,0,0,0
2015-08-11,1.72,440679,759977,1200656,0,0,0
2015-08-12,1.43,556295,796502,1352797,0,0,0
2015-08-13,1.42,356679,505809,862488,0,0,0
2015-08-14,1.6,320317,513975,834292,0,0,0
2015-08-17,1.82,407028,739703,1146731,0,0,0
2015-08-18,1.87,248918,466561,715479,0,0,0
2015-08-19,1.69,483956,818269,1302225,0,0,0
2015-08-20,2.0,658114,1312947,1971061,0,0,0
2015-08-21,2.64,954686,2521125,3475811,0,0,0
2015-08-24,1.63,797217,1303150,2100367,0,0,0
2015-08-25,1.75,549117,963405,1512522,0,0,0
2015-08-26,1.54,642300,988543,1630843,0,0,0
2015-08-27,1.44,653978,941930,1595908,0,0,0
2015-08-28,1.68,453215,762401,1215616,0,0,0
2015-08-31,1.6,352428,562722,915150,0,0,0
2015-09-01,1.68,528743,889381,1418124,0,0,0
2015-09-02,1.35,461733,623757,1085490,0,0,0
2015-09-03,1.35,449776,608941,1058717,0,0,0
2015-09-04,1.58,525669,830663,1356332,0,0,0
2015-09-08,1.14,422595,480994,903589,0,0,0
2015-09-09,1.3,525326,681255,1206581,0,0,0
2015-09-10,1.7,295942,503458,799400,0,0,0
2015-09-11,1.54,355154,545397,900551,0,0,0
2015-09-14,1.89,189166,357239,546405,0,0,0
2015-09-15,1.65,423465,697152,1120617,0,0,0
2015-09-16,1.55,491174,759907,1251081,0,0,0
2015-09-17,1.16,846761,979827,1826588,0,0,0
2015-09-18,1.47,624243,919395,1543638,0,0,0
2015-09-21,1.59,277810,440745,718555,0,0,0
2015-09-22,2.0,374559,749752,1124311,0,0,0
2015-09-23,1.38,365792,503663,869455,0,0,0
2015-09-24,1.3,663514,862910,1526424,0,0,0
2015-09-25,1.97,445849,877304,1323153,0,0,0
2015-09-28,2.35,420817,989555,1410372,0,0,0
2015-09-29,1.95,326466,637960,964426,0,0,0
2015-09-30,1.69,382206,646829,1029035,0,0,0
2015-10-01,1.55,304931,472848,777779,0,0,0
2015-10-02,1.51,621381,937471,1558852,0,0,0
2015-10-05,1.31,463184,607083,1070267,0,0,0
2015-10-06,1.03,388995,400028,789023,0,0,0
2015-10-07,1.44,399933,575087,975020,0,0,0
2015-10-08,1.33,519017,691944,1210961,0,0,0
2015-10-09,0.99,409016,405345,814361,0,0,0
2015-10-12,1.09,308281,336668,644949,0,0,0
2015-10-13,1.78,322784,573301,896085,0,0,0
2015-10-14,1.15,443524,509421,952945,0,0,0
2015-10-15,1.42,392312,557640,949952,0,0,0
2015-10-16,1.18,574040,675081,1249121,0,0,0
2015-10-19,1.02,276422,282535,558957,0,0,0
2015-10-20,1.57,203354,319027,522381,0,0,0
2015-10-21,0.92,410970,376109,787079,0,0,0
2015-10-22,1.19,431527,514931,946458,0,0,0
2015-10-23,1.17,591912,694139,1286051,0,0,0
2015-10-26,1.34,266597,356392,622989,0,0,0
2015-10-27,1.26,277048,348727,625775,0,0,0
2015-10-28,1.2,384791,463445,848236,0,0,0
2015-10-29,1.17,403954,474606,878560,0,0,0
2015-10-30,0.92,432777,399877,832654,0,0,0
2015-11-02,1.29,305707,395007,700714,0,0,0
2015-11-03,1.21,367060,443759,810819,0,0,0
2015-11-04,2.14,269396,576186,845582,0,0,0
2015-11-05,1.95,235657,460544,696201,0,0,0
2015-11-06,1.39,424253,589159,1013412,0,0,0
2015-11-09,1.59,295345,470791,766136,0,0,0
2015-11-10,2.02,179989,363135,543124,0,0,0
2015-11-11,1.58,183829,291093,474922,0,0,0
2015-11-12,1.73,302922,523405,826327,0,0,0
2015-11-13,1.65,609288,1007448,1616736,0,0,0
2015-11-16,1.48,333611,493899,827510,0,0,0
2015-11-17,1.04,393152,407367,800519,0,0,0
2015-11-18,1.35,313942,423864,737806,0,0,0
2015-11-19,1.27,302915,385366,688281,0,0,0
2015-11-20,0.87,615740,538545,1154285,0,0,0
2015-11-23,1.34,314047,420798,734845,0,0,0
2015-11-24,1.63,236436,384737,621173,0,0,0
2015-11-25,1.06,259289,274255,533544,0,0,0
2015-11-27,1.05,172042,180314,352356,0,0,0
2015-11-30,2.36,181306,428050,609356,0,0,0
2015-12-01,1.54,343171,527777,870948,0,0,0
2015-12-02,1.37,284995,391613,676608,0,0,0
2015-12-03,1.42,437907,623561,1061468,0,0,0
2015-12-04,1.04,516755,535079,1051834,0,0,0
2015-12-07,1.2,316835,381220,698055,0,0,0
2015-12-08,1.61,264369,426370,690739,0,0,0
2015-12-09,1.13,522057,592146,1114203,0,0,0
2015-12-10,1.72,242195,416642,658837,0,0,0
2015-12-11,1.67,698619,1166039,1864658,0,0,0
2015-12-14,1.38,582251,805979,1388230,0,0,0
2015-12-15,0.95,456878,433702,890580,0,0,0
2015-12-16,1.06,571851,605911,1177762,0,0,0
2015-12-17,0.98,583905,570922,1154827,0,0,0
2015-12-18,1.01,837894,845925,1683819,0,0,0
2015-12-21,0.62,583424,359865,943289,0,0,0
2015-12-22,0.9,307424,275895,583319,0,0,0
2015-12-23,0.67,536032,356636,892668,0,0,0
2015-12-24,0.75,242425,181459,423884,0,0,0
2015-12-28,1.14,188791,214987,403778,0,0,0
2015-12-29,0.83,270577,224540,495117,0,0,0
2015-12-30,1.07,204643,219425,424068,0,0,0
2015-12-31,0.88,324276,285267,609543,0,0,0
2016-01-04,1.32,511208,674075,1185283,0,0,0
2016-01-05,1.61,252261,406437,658698,0,0,0
2016-01-06,1.44,406205,584957,991162,0,0,0
2016-01-07,1.86,599679,1112666,1712345,0,0,0
2016-01-08,1.62,489455,794064,1283519,0,0,0
2016-01-11,1.86,455566,847808,1303374,0,0,0
2016-01-12,0.95,512822,488580,1001402,0,0,0
2016-01-13,1.41,563568,796478,1360046,0,0,0
2016-01-14,1.63,459370,748730,1208100,0,0,0
2016-01-15,3.06,660590,2018678,2679268,0,0,0
2016-01-19,1.48,350008,516426,866434,0,0,0
2016-01-20,1.76,810945,1424553,2235498,0,0,0
2016-01-21,1.34,475305,636128,1111433,0,0,0
2016-01-22,1.43,498465,713386,1211851,0,0,0
2016-01-25,1.22,319132,388487,707619,0,0,0
2016-01-26,1.23,319002,393225,712227,0,0,0
2016-01-27,1.1,452683,496728,949411,0,0,0
2016-01-28,1.19,353894,422325,776219,0,0,0
2016-01-29,1.13,633298,714180,1347478,0,0,0
2016-02-01,1.21,309462,374700,684162,0,0,0
2016-02-02,2.19,316988,695390,1012378,0,0,0
2016-02-03,1.12,517262,579275,1096537,0,0,0
2016-02-04,1.09,470910,511004,981914,0,0,0
2016-02-05,1.44,464011,669399,1133410,0,0,0
2016-02-08,1.76,528068,928196,1456264,0,0,0
2016-02-09,1.18,464614,546293,1010907,0,0,0
2016-02-10,1.55,332783,514929,847712,0,0,0
2016-02-11,1.0,708678,707405,1416083,0,0,0
2016-02-12,0.99,507864,503026,1010890,0,0,0
2016-02-16,1.07,405882,433765,839647,0,0,0
2016-02-17,1.49,523049,777852,1300901,0,0,0
2016-02-18,1.09,382159,417787,799946,0,0,0
2016-02-19,1.14,473166,540059,1013225,0,0,0
2016-02-22,1.55,348447,541445,889892,0,0,0
2016-02-23,1.62,294216,477134,771350,0,0,0
2016-02-24,1.44,466748,674431,1141179,0,0,0
2016-02-25,1.23,323504,398524,722028,0,0,0
2016-02-26,1.07,533539,570209,1103748,0,0,0
2016-02-29,2.07,317054,655426,972480,0,0,0
2016-03-01,1.15,451261,517530,968791,0,0,0
2016-03-02,1.37,354096,485934,840030,0,0,0
2016-03-03,1.13,500266,565062,1065328,0,0,0
2016-03-04,1.12,866806,966613,1833419,0,0,0
2016-03-07,0.96,487346,465480,952826,0,0,0
2016-03-08,1.57,295465,463043,758508,0,0,0
2016-03-09,1.31,267912,350679,618591,0,0,0
2016-03-10,1.16,444256,516752,961008,0,0,0
2016-03-11,1.62,465646,753618,1219264,0,0,0
2016-03-14,1.27,323580,412562,736142,0,0,0
2016-03-15,1.22,311651,380037,691688,0,0,0
2016-03-16,1.17,450028,528509,978537,0,0,0
2016-03-17,0.69,813385,565300,1378685,0,0,0
2016-03-18,0.88,641309,562671,1203980,0,0,0
2016-03-21,0.92,234017,215678,449695,0,0,0
2016-03-22,1.33,276853,369233,646086,0,0,0
2016-03-23,1.47,304292,447621,751913,0,0,0
2016-03-24,1.5,261538,392626,654164,0,0,0
2016-03-28,1.28,155068,198284,353352,0,0,0
2016-03-29,1.5,398035,595132,993167,0,0,0
2016-03-30,3.41,315646,1077181,1392827,0,0,0
2016-03-31,2.14,325354,696495,1021849,0,0,0
2016-04-01,1.32,352228,464326,816554,0,0,0
2016-04-04,1.68,211475,356278,567753,0,0,0
2016-04-05,1.66,279378,462993,742371,0,0,0
2016-04-06,1.8,248309,446014,694323,0,0,0
2016-04-07,1.83,348654,636993,985647,0,0,0
2016-04-08,0.98,401568,393957,795525,0,0,0
2016-04-11,0.87,396989,345034,742023,0,0,0
2016-04-12,1.42,363336,516024,879360,0,0,0
2016-04-13,0.68,651359,443919,1095278,0,0,0
2016-04-14,0.94,378985,357351,736336,0,0,0
2016-04-15,0.94,384945,361276,746221,0,0,0
2016-04-18,1.02,381775,389761,771536,0,0,0
2016-04-19,0.88,604084,531709,1135793,0,0,0
2016-04-20,0.98,429520,420618,850138,0,0,0
2016-04-21,1.53,328597,501246,829843,0,0,0
2016-04-22,1.32,362203,479316,841519,0,0,0
2016-04-25,1.36,206768,280716,487484,0,0,0
2016-04-26,1.08,289549,313520,603069,0,0,0
2016-04-27,1.63,327871,533883,861754,0,0,0
2016-04-28,1.35,370167,498817,868984,0,0,0
2016-04-29,1.27,595878,757331,1353209,0,0,0
2016-05-02,1.76,274677,482963,757640,0,0,0
2016-05-03,1.45,371382,537628,909010,0,0,0
2016-05-04,1.58,337707,534318,872025,0,0,0
2016-05-05,1.52,295504,448136,743640,0,0,0
2016-05-06,1.61,396471,639035,1035506,0,0,0
2016-05-09,1.39,299970,415597,715567,0,0,0
2016-05-10,1.42,397224,564448,961672,0,0,0
2016-05-11,1.53,296314,454005,750319,0,0,0
2016-05-12,1.82,392096,714807,1106903,0,0,0
2016-05-13,1.56,383409,599803,983212,0,0,0
2016-05-16,1.05,333090,348093,681183,0,0,0
2016-05-17,2.18,328290,716380,1044670,0,0,0
2016-05-18,1.65,399522,660279,1059801,0,0,0
2016-05-19,2.18,388634,848430,1237064,0,0,0
2016-05-20,1.31,398362,521564,919926,0,0,0
2016-05-23,1.04,311372,322416,633788,0,0,0
2016-05-24,1.18,415455,489059,904514,0,0,0
2016-05-25,1.71,459286,787079,1246365,0,0,0
2016-05-26,1.17,314366,368579,682945,0,0,0
2016-05-27,1.04,457178,477116,934294,0,0,0
2016-05-31,1.51,318631,481232,799863,0,0,0
2016-06-01,1.42,306374,436528,742902,0,0,0
2016-06-02,1.12,320366,357494,677860,0,0,0
2016-06-03,1.04,518355,539900,1058255,0,0,0
2016-06-06,0.83,425654,354743,780397,0,0,0
2016-06-07,1.32,307154,405135,712289,0,0,0
2016-06-08,1.17,437723,510891,948614,0,0,0
2016-06-09,1.3,372632,484127,856759,0,0,0
2016-06-10,1.4,556784,778588,1335372,0,0,0
2016-06-13,1.64,456898,750616,1207514,0,0,0
2016-06-14,1.64,509550,837253,1346803,0,0,0
2016-06-15,1.14,406371,465155,871526,0,0,0
2016-06-16,1.6,666122,1064005,1730127,0,0,0
2016-06-17,1.07,599836,644492,1244328,0,0,0
2016-06-20,1.51,347113,523720,870833,0,0,0
2016-06-21,0.77,479097,368258,847355,0,0,0
2016-06-22,0.95,764673,725844,1490517,0,0,0
2016-06-23,1.55,576414,893044,1469458,0,0,0
2016-06-24,1.34,939375,1262481,2201856,0,0,0
2016-06-27,2.1,612063,1282880,1894943,0,0,0
2016-06-28,1.61,503618,812025,1315643,0,0,0
2016-06-29,1.46,605516,881444,1486960,0,0,0
2016-06-30,1.98,524864,1039793,1564657,0,0,0
2016-07-01,1.15,577469,664345,1241814,0,0,0
2016-07-05,1.49,355225,529954,885179,0,0,0
2016-07-06,0.95,574278,547843,1122121,0,0,0
2016-07-07,0.82,594381,489824,1084205,0,0,0
2016-07-08,0.59,1235905,734690,1970595,0,0,0
2016-07-11,0.71,640513,451654,1092167,0,0,0
2016-07-12,0.69,807673,557094,1364767,0,0,0
2016-07-13,1.23,435289,533657,968946,0,0,0
2016-07-14,0.54,957289,516390,1473679,0,0,0
2016-07-15,1.0,476887,477143,954030,0,0,0
2016-07-18,1.17,268317,313542,581859,0,0,0
2016-07-19,1.48,267332,396762,664094,0,0,0
2016-07-20,0.73,629782,462204,1091986,0,0,0
2016-07-21,1.61,319794,515112,834906,0,0,0
2016-07-22,0.72,644247,462984,1107231,0,0,0
2016-07-25,1.55,242701,376209,618910,0,0,0
2016-07-26,1.29,327377,421076,748453,0,0,0
2016-07-27,1.27,358262,454949,813211,0,0,0
2016-07-28,0.92,347514,321299,668813,0,0,0
2016-07-29,1.61,444829,715550,1160379,0,0,0
2016-08-01,2.09,291532,607962,899494,0,0,0
2016-08-02,2.25,368758,830270,1199028,0,0,0
2016-08-03,1.2,290446,348907,639353,0,0,0
2016-08-04,1.37,253404,347908,601312,0,0,0
2016-08-05,1.04,600545,624177,1224722,0,0,0
2016-08-08,0.97,316335,306260,622595,0,0,0
2016-08-09,1.19,281595,335868,617463,0,0,0
2016-08-10,1.61,256205,412436,668641,0,0,0
2016-08-11,1.45,351438,510872,862310,0,0,0
2016-08-12,1.12,411893,462175,874068,0,0,0
2016-08-15,1.29,311491,402864,714355,0,0,0
2016-08-16,1.66,325426,540975,866401,0,0,0
2016-08-17,1.33,389808,517212,907020,0,0,0
2016-08-18,1.08,337126,364531,701657,0,0,0
2016-08-19,0.71,567832,400484,968316,0,0,0
2016-08-22,1.4,300570,421458,722028,0,0,0
2016-08-23,1.36,306127,416019,722146,0,0,0
2016-08-24,1.45,352635,512364,864999,0,0,0
2016-08-25,1.2,349231,418479,767710,0,0,0
2016-08-26,1.42,529912,752055,1281967,0,0,0
2016-08-29,1.22,266863,324970,591833,0,0,0
2016-08-30,1.19,301713,358987,660700,0,0,0
2016-08-31,1.26,405156,508925,914081,0,0,0
2016-09-01,1.13,502940,567073,1070013,0,0,0
2016-09-02,1.01,515611,521019,1036630,0,0,0
2016-09-06,1.09,457392,498959,956351,0,0,0
2016-09-07,1.15,319137,367871,687008,0,0,0
2016-09-08,1.23,380918,466992,847910,0,0,0
2016-09-09,1.55,768678,1191771,1960449,0,0,0
2016-09-12,1.57,542174,849351,1391525,0,0,0
2016-09-13,1.92,527037,1013840,1540877,0,0,0
2016-09-14,2.71,396029,1072400,1468429,0,0,0
2016-09-15,1.17,444435,519860,964295,0,0,0
2016-09-16,1.28,497359,637147,1134506,0,0,0
2016-09-19,1.11,347545,384198,731743,0,0,0
2016-09-20,1.73,408744,705662,1114406,0,0,0
2016-09-21,1.35,535048,724055,1259103,0,0,0
2016-09-22,1.38,509475,700824,1210299,0,0,0
2016-09-23,1.52,400429,607231,1007660,0,0,0
2016-09-26,1.96,266525,522884,789409,0,0,0
2016-09-27,1.56,304232,476060,780292,0,0,0
2016-09-28,1.12,418275,470168,888443,0,0,0
2016-09-29,1.42,480486,683394,1163880,0,0,0
2016-09-30,1.38,384200,529459,913659,0,0,0
2016-10-03,1.34,344880,460642,805522,0,0,0
2016-10-04,1.3,431959,561328,993287,0,0,0
2016-10-05,0.78,650933,509666,1160599,0,0,0
2016-10-06,1.7,307541,523599,831140,0,0,0
2016-10-07,1.69,433717,732278,1165995,0,0,0
2016-10-10,1.15,359920,415098,775018,0,0,0
2016-10-11,1.95,448532,876629,1325161,0,0,0
2016-10-12,1.85,216163,399421,615584,0,0,0
2016-10-13,2.08,373689,775729,1149418,0,0,0
2016-10-14,1.44,438529,632843,1071372,0,0,0
2016-10-17,1.62,216237,349856,566093,0,0,0
2016-10-18,1.89,272763,516182,788945,0,0,0
2016-10-19,1.58,318670,502721,821391,0,0,0
2016-10-20,2.01,316921,638452,955373,0,0,0
2016-10-21,1.84,359895,663662,1023557,0,0,0
2016-10-24,1.35,249114,336670,585784,0,0,0
2016-10-25,1.42,316142,449102,765244,0,0,0
2016-10-26,1.3,297331,386797,684128,0,0,0
2016-10-27,1.42,353758,503994,857752,0,0,0
2016-10-28,1.5,602084,905048,1507132,0,0,0
2016-10-31,1.35,386767,521030,907797,0,0,0
2016-11-01,2.23,502078,1120770,1622848,0,0,0
2016-11-02,1.85,376230,694629,1070859,0,0,0
2016-11-03,1.97,453557,895296,1348853,0,0,0
2016-11-04,1.99,504113,1003255,1507368,0,0,0
2016-11-07,2.32,502819,1168561,1671380,0,0,0
2016-11-08,2.7,468791,1264902,1733693,0,0,0
2016-11-09,1.53,868233,1331252,2199485,0,0,0
2016-11-10,1.29,730804,941843,1672647,0,0,0
2016-11-11,1.66,540355,897576,1437931,0,0,0
2016-11-14,1.34,518569,692968,1211537,0,0,0
2016-11-15,1.01,598261,602290,1200551,0,0,0
2016-11-16,1.84,494735,909565,1404300,0,0,0
2016-11-17,1.07,512964,550521,1063485,0,0,0
2016-11-18,1.24,475666,588200,1063866,0,0,0
2016-11-21,1.04,451981,470784,922765,0,0,0
2016-11-22,1.34,387927,519253,907180,0,0,0
2016-11-23,1.28,387750,496289,884039,0,0,0
2016-11-25,0.89,333751,295548,629299,0,0,0
2016-11-28,1.28,366845,469880,836725,0,0,0
2016-11-29,1.26,281347,353362,634709,0,0,0
2016-11-30,1.5,387626,583001,970627,0,0,0
2016-12-01,1.37,522821,716062,1238883,0,0,0
2016-12-02,1.26,405972,512295,918267,0,0,0
2016-12-05,1.16,347961,402316,750277,0,0,0
2016-12-06,1.26,254765,322096,576861,0,0,0
2016-12-07,1.1,659143,725811,1384954,0,0,0
2016-12-08,0.89,686398,612973,1299371,0,0,0
2016-12-09,1.03,624140,640585,1264725,0,0,0
2016-12-12,0.82,458890,374254,833144,0,0,0
2016-12-13,0.6,843126,509813,1352939,0,0,0
2016-12-14,1.3,491005,638101,1129106,0,0,0
2016-12-15,0.79,675317,533488,1208805,0,0,0
2016-12-16,1.47,395961,582590,978551,0,0,0
2016-12-19,1.9,255331,485865,741196,0,0,0
2016-12-20,1.28,255986,327888,583874,0,0,0
2016-12-21,0.77,404906,312634,717540,0,0,0
2016-12-22,1.68,256361,430739,687100,0,0,0
2016-12-23,1.17,226011,264460,490471,0,0,0
2016-12-27,1.99,186271,369806,556077,0,0,0
2016-12-28,1.62,266783,431022,697805,0,0,0
2016-12-29,1.05,354955,371551,726506,0,0,0
2016-12-30,1.51,361269,545664,906933,0,0,0
2017-01-03,1.25,288465,361446,649911,0,0,0
2017-01-04,1.13,410800,462933,873733,0,0,0
2017-01-05,1.98,387909,768800,1156709,0,0,0
2017-01-06,1.43,419181,600688,1019869,0,0,0
2017-01-09,1.52,239785,364226,604011,0,0,0
2017-01-10,1.89,241624,457644,699268,0,0,0
2017-01-11,1.25,379349,475418,854767,0,0,0
2017-01-12,1.5,349261,523382,872643,0,0,0
2017-01-13,1.72,357375,614563,971938,0,0,0
2017-01-17,1.5,315784,473481,789265,0,0,0
2017-01-18,2.17,298763,648170,946933,0,0,0
2017-01-19,1.93,292488,564152,856640,0,0,0
2017-01-20,1.07,663831,709719,1373550,0,0,0
2017-01-23,1.64,267401,439538,706939,0,0,0
2017-01-24,1.23,376391,463581,839972,0,0,0
2017-01-25,0.62,954690,595049,1549739,0,0,0
2017-01-26,1.53,357841,546448,904289,0,0,0
2017-01-27,1.72,307779,528872,836651,0,0,0
2017-01-30,1.96,322108,632026,954134,0,0,0
2017-01-31,1.78,296215,527207,823422,0,0,0
2017-02-01,1.71,291621,497721,789342,0,0,0
2017-02-02,1.31,270799,355220,626019,0,0,0
2017-02-03,0.44,1266647,563240,1829887,0,0,0
2017-02-06,1.43,278410,397523,675933,0,0,0
2017-02-07,2.91,262540,763286,1025826,0,0,0
2017-02-08,1.92,265514,509822,775336,0,0,0
2017-02-09,1.84,368304,677118,1045422,0,0,0
2017-02-10,1.57,445251,697837,1143088,0,0,0
2017-02-13,0.5,969997,484373,1454370,0,0,0
2017-02-14,1.01,471338,476091,947429,0,0,0
2017-02-15,1.04,596034,618334,1214368,0,0,0
2017-02-16,1.71,441842,754411,1196253,0,0,0
2017-02-17,1.44,535226,771958,1307184,0,0,0
2017-02-21,1.17,525370,615624,1140994,0,0,0
2017-02-22,1.42,323317,460104,783421,0,0,0
2017-02-23,1.52,373446,568453,941899,0,0,0
2017-02-24,1.24,475599,591366,1066965,0,0,0
2017-02-27,0.78,483667,376066,859733,0,0,0
2017-02-28,2.13,339521,723656,1063177,0,0,0
2017-03-01,1.23,648353,795541,1443894,0,0,0
2017-03-02,1.35,421810,568517,990327,0,0,0
2017-03-03,0.87,671268,581403,1252671,0,0,0
2017-03-06,1.33,275192,366620,641812,0,0,0
2017-03-07,1.33,315624,419431,735055,0,0,0
2017-03-08,1.32,470291,619187,1089478,0,0,0
2017-03-09,1.64,414201,679378,1093579,0,0,0
2017-03-10,1.12,652360,728332,1380692,0,0,0
2017-03-13,1.08,299426,324028,623454,0,0,0
2017-03-14,0.98,426312,419099,845411,0,0,0
2017-03-15,0.77,833841,644458,1478299,0,0,0
2017-03-16,0.86,622821,536551,1159372,0,0,0
2017-03-17,1.21,521399,631165,1152564,0,0,0
2017-03-20,1.59,280958,445856,726814,0,0,0
2017-03-21,1.69,575942,970854,1546796,0,0,0
2017-03-22,1.24,641441,796673,1438114,0,0,0
2017-03-23,1.67,423216,708757,1131973,0,0,0
2017-03-24,1.99,413026,822022,1235048,0,0,0
2017-03-27,1.75,284046,495855,779901,0,0,0
2017-03-28,1.26,382907,483572,866479,0,0,0
2017-03-29,1.01,300291,303330,603621,0,0,0
2017-03-30,1.28,396375,505647,902022,0,0,0
2017-03-31,1.89,355769,671620,1027389,0,0,0
2017-04-03,1.08,411078,442569,853647,0,0,0
2017-04-04,2.65,286804,760630,1047434,0,0,0
2017-04-05,1.41,497129,698833,1195962,0,0,0
2017-04-06,1.12,444712,498256,942968,0,0,0
2017-04-07,1.01,559849,566635,1126484,0,0,0
2017-04-10,1.81,531188,959429,1490617,0,0,0
2017-04-11,1.2,578390,692585,1270975,0,0,0
2017-04-12,1.02,478131,488071,966202,0,0,0
2017-04-13,1.3,516372,672213,1188585,0,0,0
2017-04-17,1.33,379338,504365,883703,0,0,0
2017-04-18,1.01,434004,437957,871961,0,0,0
2017-04-19,2.0,388054,777738,1165792,0,0,0
2017-04-20,1.38,506179,698047,1204226,0,0,0
2017-04-21,1.67,555595,928693,1484288,0,0,0
2017-04-24,1.77,418523,739367,1157890,0,0,0
2017-04-25,0.89,675213,600760,1275973,0,0,0
2017-04-26,0.76,576642,437167,1013809,0,0,0
2017-04-27,1.2,551056,660285,1211341,0,0,0
2017-04-28,1.31,431272,564092,995364,0,0,0
2017-05-01,1.1,327621,359687,687308,0,0,0
2017-05-02,1.29,272685,352766,625451,0,0,0
2017-05-03,1.48,414133,614702,1028835,0,0,0
2017-05-04,1.2,493405,593057,1086462,0,0,0
2017-05-05,1.49,464170,689709,1153879,0,0,0
2017-05-08,0.97,399433,385621,785054,0,0,0
2017-05-09,1.43,374556,534214,908770,0,0,0
2017-05-10,1.56,322116,500997,823113,0,0,0
2017-05-11,1.08,483831,520751,1004582,0,0,0
2017-05-12,1.25,402096,501879,903975,0,0,0
2017-05-15,0.79,477778,379300,857078,0,0,0
2017-05-16,1.32,367972,486981,854953,0,0,0
2017-05-17,1.84,770808,1421681,2192489,0,0,0
2017-05-18,1.81,638662,1158438,1797100,0,0,0
2017-05-19,1.47,596570,876207,1472777,0,0,0
2017-05-22,1.06,377519,399456,776975,0,0,0
2017-05-23,1.7,285049,483191,768240,0,0,0
2017-05-24,1.73,285530,493437,778967,0,0,0
2017-05-25,1.22,541034,658735,1199769,0,0,0
2017-05-26,1.12,391083,436218,827301,0,0,0
2017-05-30,0.87,397413,345863,743276,0,0,0
2017-05-31,1.68,390045,654229,1044274,0,0,0
2017-06-01,1.14,461248,527500,988748,0,0,0
2017-06-02,0.93,669900,620824,1290724,0,0,0
2017-06-05,1.08,303674,327807,631481,0,0,0
2017-06-06,0.76,908312,686195,1594507,0,0,0
2017-06-07,1.0,527577,525241,1052818,0,0,0
2017-06-08,0.97,453307,440652,893959,0,0,0
2017-06-09,1.59,675884,1076176,1752060,0,0,0
2017-06-12,1.37,452755,621243,1073998,0,0,0
2017-06-13,1.22,358752,438044,796796,0,0,0
2017-06-14,0.9,655383,589175,1244558,0,0,0
2017-06-15,0.92,784052,720352,1504404,0,0,0
2017-06-16,1.79,450779,804773,1255552,0,0,0
2017-06-19,1.27,423633,536632,960265,0,0,0
2017-06-20,1.32,489583,648519,1138102,0,0,0
2017-06-21,1.42,356421,507631,864052,0,0,0
2017-06-22,1.16,324937,376413,701350,0,0,0
2017-06-23,1.52,345036,523491,868527,0,0,0
2017-06-26,1.07,319913,342778,662691,0,0,0
2017-06-27,1.22,419400,513663,933063,0,0,0
2017-06-28,1.09,417410,454532,871942,0,0,0
2017-06-29,1.15,761034,872270,1633304,0,0,0
2017-06-30,1.36,404071,550769,954840,0,0,0
2017-07-03,1.29,206709,266000,472709,0,0,0
2017-07-05,1.39,370806,514517,885323,0,0,0
2017-07-06,1.51,396639,600574,997213,0,0,0
2017-07-07,1.24,498607,618196,1116803,0,0,0
2017-07-10,1.3,295589,385017,680606,0,0,0
2017-07-11,1.28,437258,560830,998088,0,0,0
2017-07-12,1.54,405141,622839,1027980,0,0,0
2017-07-13,1.2,308760,369429,678189,0,0,0
2017-07-14,1.1,522050,572747,1094797,0,0,0
2017-07-17,1.35,327397,441189,768586,0,0,0
2017-07-18,1.61,348962,563215,912177,0,0,0
2017-07-19,1.23,485315,597838,1083153,0,0,0
2017-07-20,1.15,497390,572781,1070171,0,0,0
2017-07-21,1.42,490093,696064,1186157,0,0,0
2017-07-24,1.05,339836,355566,695402,0,0,0
2017-07-25,1.27,418830,532232,951062,0,0,0
2017-07-26,0.9,500393,452668,953061,0,0,0
2017-07-27,1.53,560248,857593,1417841,0,0,0
2017-07-28,1.29,418357,541022,959379,0,0,0
2017-07-31,1.26,266435,334987,601422,0,0,0
2017-08-01,1.44,309060,444635,753695,0,0,0
2017-08-02,1.72,375416,644107,1019523,0,0,0
2017-08-03,1.64,300881,492909,793790,0,0,0
2017-08-04,1.2,370645,446015,816660,0,0,0
2017-08-07,1.53,273016,416865,689881,0,0,0
2017-08-08,1.26,591772,747039,1338811,0,0,0
2017-08-09,1.35,667021,898758,1565779,0,0,0
2017-08-10,1.71,857285,1463127,2320412,0,0,0
2017-08-11,1.35,1026136,1381446,2407582,0,0,0
2017-08-14,1.17,479843,560671,1040514,0,0,0
2017-08-15,1.66,338350,560330,898680,0,0,0
2017-08-16,1.85,380095,702789,1082884,0,0,0
2017-08-17,1.62,729919,1180000,1909919,0,0,0
2017-08-18,1.57,770300,1208885,1979185,0,0,0
2017-08-21,1.12,506509,565678,1072187,0,0,0
2017-08-22,1.56,422444,658227,1080671,0,0,0
2017-08-23,1.98,254110,504363,758473,0,0,0
2017-08-24,1.71,295788,506396,802184,0,0,0
2017-08-25,1.18,414262,490177,904439,0,0,0
2017-08-28,1.33,287379,382981,670360,0,0,0
2017-08-29,1.5,329274,492410,821684,0,0,0
2017-08-30,1.11,515677,573486,1089163,0,0,0
2017-08-31,1.42,599436,849620,1449056,0,0,0
2017-09-01,0.97,623095,605692,1228787,0,0,0
2017-09-05,1.83,511074,936419,1447493,0,0,0
2017-09-06,1.55,423372,656073,1079445,0,0,0
2017-09-07,1.05,367543,385383,752926,0,0,0
2017-09-08,1.84,385870,711297,1097167,0,0,0
2017-09-11,0.93,637348,593097,1230445,0,0,0
2017-09-12,1.01,505416,510622,1016038,0,0,0
2017-09-13,0.85,563170,479143,1042313,0,0,0
2017-09-14,0.94,461866,435429,897295,0,0,0
2017-09-15,1.57,411058,644916,1055974,0,0,0
2017-09-18,1.58,371619,587111,958730,0,0,0
2017-09-19,1.25,257688,321834,579522,0,0,0
2017-09-20,1.15,582614,669350,1251964,0,0,0
2017-09-21,1.2,319798,383285,703083,0,0,0
2017-09-22,1.53,319749,490300,810049,0,0,0
2017-09-25,1.58,386005,610086,996091,0,0,0
2017-09-26,1.2,363286,435476,798762,0,0,0
2017-09-27,0.82,892257,729825,1622082,0,0,0
2017-09-28,0.75,619788,462628,1082416,0,0,0
2017-09-29,1.29,521799,675097,1196896,0,0,0
2017-10-02,1.19,615100,732553,1347653,0,0,0
2017-10-03,0.78,664200,515033,1179233,0,0,0
2017-10-04,1.11,379673,421101,800774,0,0,0
2017-10-05,0.96,609736,583217,1192953,0,0,0
2017-10-06,1.2,494491,593530,1088021,0,0,0
2017-10-09,1.31,278032,364652,642684,0,0,0
2017-10-10,1.52,305362,465201,770563,0,0,0
2017-10-11,1.57,294235,460595,754830,0,0,0
2017-10-12,1.39,343528,479156,822684,0,0,0
2017-10-13,1.32,397428,526492,923920,0,0,0
2017-10-16,3.1,292443,905711,1198154,0,0,0
2017-10-17,1.43,287254,410527,697781,0,0,0
2017-10-18,1.35,402680,542203,944883,0,0,0
2017-10-19,1.41,429645,607018,1036663,0,0,0
2017-10-20,0.83,840464,697049,1537513,0,0,0
2017-10-23,1.33,597567,792725,1390292,0,0,0
2017-10-24,0.98,285185,280566,565751,0,0,0
2017-10-25,1.92,430760,825396,1256156,0,0,0
2017-10-26,1.09,311012,339527,650539,0,0,0
2017-10-27,1.31,480762,628298,1109060,0,0,0
2017-10-30,1.06,389726,414538,804264,0,0,0
2017-10-31,1.41,278837,393452,672289,0,0,0
2017-11-01,1.1,592498,653326,1245824,0,0,0
2017-11-02,1.59,269662,429355,699017,0,0,0
2017-11-03,1.14,448553,512071,960624,0,0,0
2017-11-06,1.35,415030,560425,975455,0,0,0
2017-11-07,1.78,415277,740345,1155622,0,0,0
2017-11-08,1.24,322392,400297,722689,0,0,0
2017-11-09,2.24,479327,1073857,1553184,0,0,0
2017-11-10,2.0,317709,634558,952267,0,0,0
2017-11-13,1.07,309812,330927,640739,0,0,0
2017-11-14,1.24,469862,580355,1050217,0,0,0
2017-11-15,1.28,556544,712871,1269415,0,0,0
2017-11-16,1.29,495125,636305,1131430,0,0,0
2017-11-17,1.04,617539,639171,1256710,0,0,0
2017-11-20,1.01,335064,340031,675095,0,0,0
2017-11-21,1.08,482377,520479,1002856,0,0,0
2017-11-22,0.99,322625,317962,640587,0,0,0
2017-11-24,0.74,278559,204984,483543,0,0,0
2017-11-27,0.41,967558,393108,1360666,0,0,0
2017-11-28,0.59,1106656,655844,1762500,0,0,0
2017-11-29,0.85,767688,654048,1421736,0,0,0
2017-11-30,0.93,843098,785934,1629032,0,0,0
2017-12-01,1.22,845079,1034906,1879985,0,0,0
2017-12-04,1.39,542149,753333,1295482,0,0,0
2017-12-05,1.04,498771,520560,1019331,0,0,0
2017-12-06,1.27,408794,517747,926541,0,0,0
2017-12-07,1.28,328059,421136,749195,0,0,0
2017-12-08,1.11,460028,511940,971968,0,0,0
2017-12-11,0.79,467891,368445,836336,0,0,0
2017-12-12,0.76,616381,466907,1083288,0,0,0
2017-12-13,0.65,612770,400894,1013664,0,0,0
2017-12-14,0.82,542703,446037,988740,0,0,0
2017-12-15,1.39,706118,978758,1684876,0,0,0
2017-12-18,0.72,1059824,760235,1820059,0,0,0
2017-12-19,1.16,384607,446934,831541,0,0,0
2017-12-20,0.67,616010,411089,1027099,0,0,0
2017-12-21,1.02,413099,422109,835208,0,0,0
2017-12-22,1.06,359725,381600,741325,0,0,0
2017-12-26,1.4,222291,310874,533165,0,0,0
2017-12-27,1.08,266771,288498,555269,0,0,0
2017-12-28,2.0,257964,515333,773297,0,0,0
2017-12-29,1.21,461585,558312,1019897,0,0,0
2018-01-02,1.36,483479,657749,1141228,0,0,0
2018-01-03,1.18,580964,685118,1266082,0,0,0
2018-01-04,1.26,646622,814892,1461514,0,0,0
2018-01-05,1.2,665684,795643,1461327,0,0,0
2018-01-08,1.05,536034,563507,1099541,0,0,0
2018-01-09,1.0,577829,575487,1153316,0,0,0
2018-01-10,1.59,510920,810071,1320991,0,0,0
2018-01-11,1.63,473402,772492,1245894,0,0,0
2018-01-12,1.12,788901,882784,1671685,0,0,0
2018-01-16,0.89,1029843,915382,1945225,0,0,0
2018-01-17,0.98,604064,589872,1193936,0,0,0
2018-01-18,1.15,512376,586908,1099284,0,0,0
2018-01-19,0.96,606109,579894,1186003,0,0,0
2018-01-22,1.42,515537,734516,1250053,0,0,0
2018-01-23,0.7,908998,637858,1546856,0,0,0
2018-01-24,1.09,890105,967238,1857343,0,0,0
2018-01-25,1.02,490176,501736,991912,0,0,0
2018-01-26,1.04,585840,611776,1197616,0,0,0
2018-01-29,1.06,606562,643670,1250232,0,0,0
2018-01-30,1.44,629982,906434,1536416,0,0,0
2018-01-31,1.68,578493,970373,1548866,0,0,0
2018-02-01,1.36,464754,633550,1098304,0,0,0
2018-02-02,1.92,981133,1885650,2866783,0,0,0
2018-02-05,1.67,1142720,1910500,3053220,0,0,0
2018-02-06,1.62,1024967,1655955,2680922,0,0,0
2018-02-07,1.82,660550,1200983,1861533,0,0,0
2018-02-08,2.2,692931,1521651,2214582,0,0,0
2018-02-09,1.67,855019,1425560,2280579,0,0,0
2018-02-12,0.93,801074,742943,1544017,0,0,0
2018-02-13,1.67,417613,697423,1115036,0,0,0
2018-02-14,1.58,606029,956897,1562926,0,0,0
2018-02-15,1.09,825966,902779,1728745,0,0,0
2018-02-16,1.24,732656,906712,1639368,0,0,0
2018-02-20,0.98,507775,499198,1006973,0,0,0
2018-02-21,1.55,488351,756895,1245246,0,0,0
2018-02-22,1.77,334557,592558,927115,0,0,0
2018-02-23,1.27,587425,745110,1332535,0,0,0
2018-02-26,1.26,537288,674522,1211810,0,0,0
2018-02-27,1.23,596677,733862,1330539,0,0,0
2018-02-28,1.27,570293,722184,1292477,0,0,0
2018-03-01,1.93,681378,1317447,1998825,0,0,0
2018-03-02,1.96,649634,1274152,1923786,0,0,0
2018-03-05,1.36,465592,634131,1099723,0,0,0
2018-03-06,1.61,365796,588435,954231,0,0,0
2018-03-07,1.47,441137,647026,1088163,0,0,0
2018-03-08,1.34,392980,527490,920470,0,0,0
2018-03-09,1.06,790548,837946,1628494,0,0,0
2018-03-12,1.12,499355,560741,1060096,0,0,0
2018-03-13,1.18,564295,666771,1231066,0,0,0
2018-03-14,1.55,505081,784374,1289455,0,0,0
2018-03-15,1.18,413783,486628,900411,0,0,0
2018-03-16,1.33,514297,685448,1199745,0,0,0
2018-03-19,1.64,573574,943005,1516579,0,0,0
2018-03-20,1.14,369831,420586,790417,0,0,0
2018-03-21,1.48,468081,692954,1161035,0,0,0
2018-03-22,1.62,619850,1001169,1621019,0,0,0
2018-03-23,2.47,663392,1637074,2300466,0,0,0
2018-03-26,1.57,539896,847185,1387081,0,0,0
2018-03-27,1.34,513658,688890,1202548,0,0,0
2018-03-28,1.97,503431,990846,1494277,0,0,0
2018-03-29,1.32,542788,718505,1261293,0,0,0
2018-04-02,1.84,684554,1258691,1943245,0,0,0
2018-04-03,1.65,412585,680743,1093328,0,0,0
2018-04-04,1.19,675796,805671,1481467,0,0,0
2018-04-05,0.95,607155,576102,1183257,0,0,0
2018-04-06,1.2,712645,856115,1568760,0,0,0
2018-04-09,1.31,442605,577605,1020210,0,0,0
2018-04-10,1.31,525505,690093,1215598,0,0,0
2018-04-11,1.08,515350,558248,1073598,0,0,0
2018-04-12,1.15,471249,542374,1013623,0,0,0
2018-04-13,1.38,476872,658364,1135236,0,0,0
2018-04-16,1.2,427650,512655,940305,0,0,0
2018-04-17,1.09,676095,737427,1413522,0,0,0
2018-04-18,1.15,584837,673495,1258332,0,0,0
2018-04-19,1.35,544353,736994,1281347,0,0,0
2018-04-20,1.45,503458,729233,1232691,0,0,0
2018-04-23,1.32,392867,518819,911686,0,0,0
2018-04-24,1.52,535269,815946,1351215,0,0,0
2018-04-25,1.55,384917,598413,983330,0,0,0
2018-04-26,1.33,493430,655882,1149312,0,0,0
2018-04-27,1.49,393018,585997,979015,0,0,0
2018-04-30,1.6,365002,583745,948747,0,0,0
2018-05-01,1.74,340591,593592,934183,0,0,0
2018-05-02,1.43,296657,424503,721160,0,0,0
2018-05-03,1.61,432577,697211,1129788,0,0,0
2018-05-04,1.41,604907,854327,1459234,0,0,0
2018-05-07,1.78,352384,627984,980368,0,0,0
2018-05-08,1.53,268023,408969,676992,0,0,0
2018-05-09,0.97,529655,513885,1043540,0,0,0
2018-05-10,1.06,708203,750105,1458308,0,0,0
2018-05-11,1.39,580119,807087,1387206,0,0,0
2018-05-14,1.16,399326,461995,861321,0,0,0
2018-05-15,1.4,411816,576719,988535,0,0,0
2018-05-16,1.38,340641,470673,811314,0,0,0
2018-05-17,1.08,431651,468229,899880,0,0,0
2018-05-18,1.47,394156,580958,975114,0,0,0
2018-05-21,1.25,371823,463869,835692,0,0,0
2018-05-22,1.11,324014,359488,683502,0,0,0
2018-05-23,1.44,316009,456298,772307,0,0,0
2018-05-24,1.14,313739,356802,670541,0,0,0
2018-05-25,1.18,392741,463962,856703,0,0,0
2018-05-29,1.31,538731,706631,1245362,0,0,0
2018-05-30,1.02,531724,541416,1073140,0,0,0
2018-05-31,1.96,369068,722735,1091803,0,0,0
2018-06-01,1.0,511716,510327,1022043,0,0,0
2018-06-04,1.0,370686,369124,739810,0,0,0
2018-06-05,1.53,276346,421967,698313,0,0,0
2018-06-06,1.07,537191,575854,1113045,0,0,0
2018-06-07,1.41,434618,614549,1049167,0,0,0
2018-06-08,1.43,359924,514954,874878,0,0,0
2018-06-11,0.83,403268,333915,737183,0,0,0
2018-06-12,0.99,401748,395847,797595,0,0,0
2018-06-13,0.97,539998,522089,1062087,0,0,0
2018-06-14,1.13,498502,563557,1062059,0,0,0
2018-06-15,1.18,503099,594422,1097521,0,0,0
2018-06-18,1.15,308717,355802,664519,0,0,0
2018-06-19,1.43,392080,559826,951906,0,0,0
2018-06-20,0.82,397167,326170,723337,0,0,0
2018-06-21,1.85,361760,670642,1032402,0,0,0
2018-06-22,0.99,412604,407389,819993,0,0,0
2018-06-25,2.06,518024,1065374,1583398,0,0,0
2018-06-26,1.47,345742,509660,855402,0,0,0
2018-06-27,1.73,427545,737630,1165175,0,0,0
2018-06-28,2.73,379206,1035597,1414803,0,0,0
2018-06-29,1.82,405066,738281,1143347,0,0,0
2018-07-02,1.91,289576,552896,842472,0,0,0
2018-07-03,1.25,220116,274227,494343,0,0,0
2018-07-05,1.04,359100,372830,731930,0,0,0
2018-07-06,1.31,423413,555574,978987,0,0,0
2018-07-09,1.48,436465,645974,1082439,0,0,0
2018-07-10,1.36,403735,549125,952860,0,0,0
2018-07-11,1.54,349733,537454,887187,0,0,0
2018-07-12,1.66,370587,615417,986004,0,0,0
2018-07-13,1.52,364737,554917,919654,0,0,0
2018-07-16,1.48,264833,391587,656420,0,0,0
2018-07-17,1.36,350060,474565,824625,0,0,0
2018-07-18,0.99,425158,420429,845587,0,0,0
2018-07-19,1.01,396785,402064,798849,0,0,0
2018-07-20,1.18,474067,557422,1031489,0,0,0
2018-07-23,1.31,343138,450386,793524,0,0,0
2018-07-24,1.07,595525,639180,1234705,0,0,0
2018-07-25,0.99,450904,447125,898029,0,0,0
2018-07-26,1.31,292602,382312,674914,0,0,0
2018-07-27,1.22,537466,653246,1190712,0,0,0
2018-07-30,1.71,361417,618545,979962,0,0,0
2018-07-31,1.38,397153,547185,944338,0,0,0
2018-08-01,1.36,331744,450073,781817,0,0,0
2018-08-02,1.7,403817,684493,1088310,0,0,0
2018-08-03,1.15,332026,380235,712261,0,0,0
2018-08-06,1.38,385514,533874,919388,0,0,0
2018-08-07,1.56,390972,610903,1001875,0,0,0
2018-08-08,1.54,282884,436141,719025,0,0,0
2018-08-09,1.91,262027,501275,763302,0,0,0
2018-08-10,1.88,463921,870045,1333966,0,0,0
2018-08-13,1.46,389591,566912,956503,0,0,0
2018-08-14,1.11,310227,345486,655713,0,0,0
2018-08-15,1.89,589436,1115301,1704737,0,0,0
2018-08-16,1.45,431564,626593,1058157,0,0,0
2018-08-17,1.44,482130,696167,1178297,0,0,0
2018-08-20,0.79,355634,279556,635190,0,0,0
2018-08-21,1.14,421603,479915,901518,0,0,0
2018-08-22,1.17,329662,386191,715853,0,0,0
2018-08-23,2.44,276850,675303,952153,0,0,0
2018-08-24,1.17,440098,517021,957119,0,0,0
2018-08-27,1.0,441528,439741,881269,0,0,0
2018-08-28,1.2,323334,389587,712921,0,0,0
2018-08-29,1.4,352030,494395,846425,0,0,0
2018-08-30,1.38,339174,469068,808242,0,0,0
2018-08-31,1.49,392330,584405,976735,0,0,0
2018-09-04,1.24,350441,435785,786226,0,0,0
2018-09-05,1.81,338626,613345,951971,0,0,0
2018-09-06,0.97,494001,481614,975615,0,0,0
2018-09-07,1.44,427524,614916,1042440,0,0,0
2018-09-10,1.83,219814,401723,621537,0,0,0
2018-09-11,1.04,358408,371180,729588,0,0,0
2018-09-12,1.18,372388,439135,811523,0,0,0
2018-09-13,1.03,425328,438708,864036,0,0,0
2018-09-14,1.08,469495,506010,975505,0,0,0
2018-09-17,1.1,419894,462674,882568,0,0,0
2018-09-18,1.03,348944,358640,707584,0,0,0
2018-09-19,1.18,359508,423008,782516,0,0,0
2018-09-20,0.69,780773,541934,1322707,0,0,0
2018-09-21,1.66,469199,779383,1248582,0,0,0
2018-09-24,0.98,333522,325751,659273,0,0,0
2018-09-25,1.09,287875,313545,601420,0,0,0
2018-09-26,1.05,429324,452489,881813,0,0,0
2018-09-27,0.84,437641,367642,805283,0,0,0
2018-09-28,1.3,505145,656904,1162049,0,0,0
2018-10-01,1.6,329154,525167,854321,0,0,0
2018-10-02,0.71,476678,337314,813992,0,0,0
2018-10-03,1.08,491449,530548,1021997,0,0,0
2018-10-04,1.65,545532,901173,1446705,0,0,0
2018-10-05,1.78,553368,985962,1539330,0,0,0
2018-10-08,1.72,457735,788752,1246487,0,0,0
2018-10-09,1.86,303056,562728,865784,0,0,0
2018-10-10,2.51,693494,1740793,2434287,0,0,0
2018-10-11,1.9,990382,1879210,2869592,0,0,0
2018-10-12,1.74,753029,1313113,2066142,0,0,0
2018-10-15,1.8,411875,742979,1154854,0,0,0
2018-10-16,1.52,611522,927265,1538787,0,0,0
2018-10-17,1.5,432300,649109,1081409,0,0,0
2018-10-18,2.29,463968,1062730,1526698,0,0,0
2018-10-19,1.52,656015,994248,1650263,0,0,0
2018-10-22,1.73,348006,603488,951494,0,0,0
2018-10-23,1.42,832464,1182256,2014720,0,0,0
2018-10-24,1.98,630999,1252172,1883171,0,0,0
2018-10-25,1.96,564745,1107858,1672603,0,0,0
2018-10-26,1.8,1024576,1839802,2864378,0,0,0
2018-10-29,1.72,540142,927528,1467670,0,0,0
2018-10-30,1.63,428031,695928,1123959,0,0,0
2018-10-31,2.06,558885,1153373,1712258,0,0,0
2018-11-01,1.07,648188,693316,1341504,0,0,0
2018-11-02,1.07,793992,847898,1641890,0,0,0
2018-11-05,1.3,410487,532077,942564,0,0,0
2018-11-06,1.25,423024,529099,952123,0,0,0
2018-11-07,1.01,1003727,1010151,2013878,0,0,0
2018-11-08,1.66,398332,662085,1060417,0,0,0
2018-11-09,1.66,587090,977160,1564250,0,0,0
2018-11-12,2.13,412519,877317,1289836,0,0,0
2018-11-13,1.27,496941,633291,1130232,0,0,0
2018-11-14,1.78,510699,910982,1421681,0,0,0
2018-11-15,0.71,1264166,896909,2161075,0,0,0
2018-11-16,0.88,795464,699674,1495138,0,0,0
2018-11-19,1.32,554628,730055,1284683,0,0,0
2018-11-20,1.29,751677,967003,1718680,0,0,0
2018-11-21,1.26,437754,552300,990054,0,0,0
2018-11-23,0.9,332394,299635,632029,0,0,0
2018-11-26,0.91,482262,438117,920379,0,0,0
2018-11-27,0.84,455058,383078,838136,0,0,0
2018-11-28,0.94,876698,821272,1697970,0,0,0
2018-11-29,1.09,653045,710582,1363627,0,0,0
2018-11-30,0.77,804159,623199,1427358,0,0,0
2018-12-03,0.61,1180526,720653,1901179,0,0,0
2018-12-04,0.84,1301846,1091357,2393203,0,0,0
2018-12-06,1.28,1043410,1335059,2378469,0,0,0
2018-12-07,1.32,928769,1226630,2155399,0,0,0
2018-12-10,1.42,743612,1057280,1800892,0,0,0
2018-12-11,1.27,546806,694248,1241054,0,0,0
2018-12-12,1.09,552113,601419,1153532,0,0,0
2018-12-13,1.79,315250,564365,879615,0,0,0
2018-12-14,1.41,560304,789574,1349878,0,0,0
2018-12-17,2.11,693938,1464689,2158627,0,0,0
2018-12-18,1.46,686831,1001516,1688347,0,0,0
2018-12-19,1.29,724731,936761,1661492,0,0,0
2018-12-20,3.26,746224,2431883,3178107,0,0,0
2018-12-21,2.55,742380,1892821,2635201,0,0,0
2018-12-24,1.96,499643,977651,1477294,0,0,0
2018-12-26,1.15,787313,904429,1691742,0,0,0
2018-12-27,1.12,559173,626608,1185781,0,0,0
2018-12-28,0.97,660556,641167,1301723,0,0,0
2018-12-31,1.26,434382,546308,980690,0,0,0
2019-01-02,1.32,412268,545472,957740,0,0,0
2019-01-03,1.9,512365,975968,1488333,0,0,0
2019-01-04,0.89,867214,769616,1636830,0,0,0
2019-01-07,1.06,580504,617808,1198312,0,0,0
2019-01-08,1.39,414529,575326,989855,0,0,0
2019-01-09,1.26,554455,700696,1255151,0,0,0
2019-01-10,1.77,401840,711912,1113752,0,0,0
2019-01-11,1.35,434431,585035,1019466,0,0,0
2019-01-14,1.68,338546,567646,906192,0,0,0
2019-01-15,1.38,438962,603693,1042655,0,0,0
2019-01-16,1.48,497965,735336,1233301,0,0,0
2019-01-17,1.3,515996,669566,1185562,0,0,0
2019-01-18,1.23,747862,920686,1668548,0,0,0
2019-01-22,1.4,435069,610878,1045947,0,0,0
2019-01-23,1.8,352003,634410,986413,0,0,0
2019-01-24,1.66,259480,431878,691358,0,0,0
2019-01-25,0.81,731869,589521,1321390,0,0,0
2019-01-28,1.29,386906,497715,884621,0,0,0
2019-01-29,0.95,391875,371357,763232,0,0,0
2019-01-30,0.98,579038,566641,1145679,0,0,0
2019-01-31,1.08,604493,652149,1256642,0,0,0
2019-02-01,1.45,453890,656045,1109935,0,0,0
2019-02-04,1.24,404656,502482,907138,0,0,0
2019-02-05,0.8,623393,496163,1119556,0,0,0
2019-02-06,1.61,327634,526289,853923,0,0,0
2019-02-07,1.17,594288,696723,1291011,0,0,0
2019-02-08,1.31,479447,629348,1108795,0,0,0
2019-02-11,1.08,326941,353244,680185,0,0,0
2019-02-12,0.9,553635,495591,1049226,0,0,0
2019-02-13,0.99,536875,530445,1067320,0,0,0
2019-02-14,1.35,466885,630270,1097155,0,0,0
2019-02-15,1.17,603286,707947,1311233,0,0,0
2019-02-19,1.2,460899,550843,1011742,0,0,0
2019-02-20,0.96,593655,570327,1163982,0,0,0
2019-02-21,1.12,410703,460927,871630,0,0,0
2019-02-22,0.84,676777,569530,1246307,0,0,0
2019-02-25,1.25,495822,618642,1114464,0,0,0
2019-02-26,1.43,266174,381480,647654,0,0,0
2019-02-27,1.46,357263,521567,878830,0,0,0
2019-02-28,1.23,307692,378539,686231,0,0,0
2019-03-01,1.22,454415,552846,1007261,0,0,0
2019-03-04,1.53,525748,801857,1327605,0,0,0
2019-03-05,1.1,311640,342337,653977,0,0,0
2019-03-06,1.53,389736,596140,985876,0,0,0
2019-03-07,1.58,441758,698359,1140117,0,0,0
2019-03-08,1.36,525919,713820,1239739,0,0,0
2019-03-11,1.15,482396,552557,1034953,0,0,0
2019-03-12,1.21,424055,512170,936225,0,0,0
2019-03-13,0.95,522361,497701,1020062,0,0,0
2019-03-14,1.16,393742,457437,851179,0,0,0
2019-03-15,0.9,614538,551042,1165580,0,0,0
2019-03-18,1.2,430289,514421,944710,0,0,0
2019-03-19,1.54,375920,578981,954901,0,0,0
2019-03-20,1.33,550865,732192,1283057,0,0,0
2019-03-21,0.9,729547,659191,1388738,0,0,0
2019-03-22,1.36,647898,881191,1529089,0,0,0
2019-03-25,1.44,456894,656074,1112968,0,0,0
2019-03-26,0.94,389779,366131,755910,0,0,0
2019-03-27,1.52,370115,560874,930989,0,0,0
2019-03-28,0.99,367130,361809,728939,0,0,0
2019-03-29,0.97,510915,493294,1004209,0,0,0
2019-04-01,0.89,541028,479793,1020821,0,0,0
2019-04-02,1.19,301967,360612,662579,0,0,0
2019-04-03,1.39,425975,590122,1016097,0,0,0
2019-04-04,1.01,316867,318617,635484,0,0,0
2019-04-05,1.07,456561,489384,945945,0,0,0
2019-04-08,0.81,392610,318686,711296,0,0,0
2019-04-09,1.5,334794,503374,838168,0,0,0
2019-04-10,1.15,273556,315699,589255,0,0,0
2019-04-11,1.36,315869,430605,746474,0,0,0
2019-04-12,0.75,617391,463734,1081125,0,0,0
2019-04-15,0.95,364182,345319,709501,0,0,0
2019-04-16,0.59,644586,382617,1027203,0,0,0
2019-04-17,1.26,439828,555088,994916,0,0,0
2019-04-18,1.17,457951,533607,991558,0,0,0
2019-04-22,1.32,239351,315430,554781,0,0,0
2019-04-23,1.11,509149,563752,1072901,0,0,0
2019-04-24,1.02,366717,374828,741545,0,0,0
2019-04-25,1.41,321507,454148,775655,0,0,0
2019-04-26,1.01,368363,371174,739537,0,0,0
2019-04-29,1.08,316880,341036,657916,0,0,0
2019-04-30,1.52,420408,639017,1059425,0,0,0
2019-05-01,1.23,491476,604540,1096016,0,0,0
2019-05-02,1.5,364528,546056,910584,0,0,0
2019-05-03,1.03,438816,450680,889496,0,0,0
2019-05-06,1.51,449274,677716,1126990,0,0,0
2019-05-07,1.3,794986,1030904,1825890,0,0,0
2019-05-08,1.47,399670,586209,985879,0,0,0
2019-05-09,2.11,529699,1119391,1649090,0,0,0
2019-05-10,1.49,550011,819862,1369873,0,0,0
2019-05-13,1.7,582646,992268,1574914,0,0,0
2019-05-14,1.05,471326,496535,967861,0,0,0
2019-05-15,1.76,474267,835473,1309740,0,0,0
2019-05-16,1.75,480729,839314,1320043,0,0,0
2019-05-17,1.71,450114,770845,1220959,0,0,0
2019-05-20,1.29,360754,464796,825550,0,0,0
2019-05-21,1.08,356870,383681,740551,0,0,0
2019-05-22,1.27,307623,389226,696849,0,0,0
2019-05-23,1.57,581155,913402,1494557,0,0,0
2019-05-24,1.38,343591,473458,817049,0,0,0
2019-05-28,1.57,335510,526227,861737,0,0,0
2019-05-29,2.62,506183,1327009,1833192,0,0,0
2019-05-30,1.85,351930,650175,1002105,0,0,0
2019-05-31,1.59,534681,850074,1384755,0,0,0
2019-06-03,1.62,500024,809472,1309496,0,0,0
2019-06-04,1.29,435510,561070,996580,0,0,0
2019-06-05,1.25,481695,603379,1085074,0,0,0
2019-06-06,1.18,441918,522402,964320,0,0,0
2019-06-07,1.28,573464,733310,1306774,0,0,0
2019-06-10,1.23,466949,575378,1042327,0,0,0
2019-06-11,1.32,379909,503060,882969,0,0,0
2019-06-12,1.33,315726,419236,734962,0,0,0
2019-06-13,1.16,354613,410261,764874,0,0,0
2019-06-14,1.28,360258,460320,820578,0,0,0
2019-06-17,1.16,297920,345394,643314,0,0,0
2019-06-18,1.13,522860,592909,1115769,0,0,0
2019-06-19,0.99,493424,487924,981348,0,0,0
2019-06-20,0.7,963349,670511,1633860,0,0,0
2019-06-21,0.97,485914,469775,955689,0,0,0
2019-06-24,1.1,365089,403363,768452,0,0,0
2019-06-25,1.11,557614,620414,1178028,0,0,0
2019-06-26,0.9,409355,367401,776756,0,0,0
2019-06-27,1.06,323331,341680,665011,0,0,0
2019-06-28,0.98,541244,532152,1073396,0,0,0
2019-07-01,1.26,506979,639469,1146448,0,0,0
2019-07-02,1.23,388514,477502,866016,0,0,0
2019-07-03,0.86,364217,314442,678659,0,0,0
2019-07-05,0.99,412888,407702,820590,0,0,0
2019-07-08,1.2,334387,402739,737126,0,0,0
2019-07-09,0.99,308976,305101,614077,0,0,0
2019-07-10,0.88,478532,422565,901097,0,0,0
2019-07-11,1.02,386897,393227,780124,0,0,0
2019-07-12,1.32,415743,549200,964943,0,0,0
2019-07-15,1.02,323465,328910,652375,0,0,0
2019-07-16,1.09,377977,412409,790386,0,0,0
2019-07-17,1.25,395587,494395,889982,0,0,0
2019-07-18,1.01,512977,520385,1033362,0,0,0
2019-07-19,1.53,490058,751955,1242013,0,0,0
2019-07-22,1.22,293383,358411,651794,0,0,0
2019-07-23,0.91,400845,364327,765172,0,0,0
2019-07-24,1.08,357730,385476,743206,0,0,0
2019-07-25,1.04,316436,329474,645910,0,0,0
2019-07-26,1.4,300467,420819,721286,0,0,0
2019-07-29,1.13,252001,284814,536815,0,0,0
2019-07-30,1.29,301987,389089,691076,0,0,0
2019-07-31,1.51,534034,805270,1339304,0,0,0
2019-08-01,1.9,580293,1102191,1682484,0,0,0
2019-08-02,1.71,545562,932307,1477869,0,0,0
2019-08-05,2.18,718579,1565597,2284176,0,0,0
2019-08-06,1.51,465045,702928,1167973,0,0,0
2019-08-07,1.87,617379,1154537,1771916,0,0,0
2019-08-08,1.22,519601,635898,1155499,0,0,0
2019-08-09,1.2,474560,569961,1044521,0,0,0
2019-08-12,1.56,467902,728503,1196405,0,0,0
2019-08-13,1.22,448818,545713,994531,0,0,0
2019-08-14,1.63,650661,1061804,1712465,0,0,0
2019-08-15,1.52,491947,746263,1238210,0,0,0
2019-08-16,1.53,503679,770239,1273918,0,0,0
2019-08-19,1.1,452577,497660,950237,0,0,0
2019-08-20,1.12,293186,327537,620723,0,0,0
2019-08-21,2.54,350681,891922,1242603,0,0,0
2019-08-22,1.35,325274,438162,763436,0,0,0
2019-08-23,1.25,766087,954661,1720748,0,0,0
2019-08-26,1.28,420873,539083,959956,0,0,0
2019-08-27,1.07,494397,528857,1023254,0,0,0
2019-08-28,1.86,320131,594144,914275,0,0,0
2019-08-29,1.29,460682,593954,1054636,0,0,0
2019-08-30,1.47,379069,556507,935576,0,0,0
2019-09-03,1.26,415738,523596,939334,0,0,0
2019-09-04,0.95,429940,409275,839215,0,0,0
2019-09-05,1.01,610288,619320,1229608,0,0,0
2019-09-06,1.22,385868,471402,857270,0,0,0
2019-09-09,1.47,359914,529381,889295,0,0,0
2019-09-10,0.96,430140,414347,844487,0,0,0
2019-09-11,0.95,571626,542923,1114549,0,0,0
2019-09-12,0.86,524260,452097,976357,0,0,0
2019-09-13,0.87,612314,533227,1145541,0,0,0
2019-09-16,1.8,433282,781317,1214599,0,0,0
2019-09-17,1.24,400654,496398,897052,0,0,0
2019-09-18,1.39,493193,684206,1177399,0,0,0
2019-09-19,1.88,449138,846597,1295735,0,0,0
2019-09-20,1.66,419766,696847,1116613,0,0,0
2019-09-23,1.28,371146,475707,846853,0,0,0
2019-09-24,1.64,533089,873381,1406470,0,0,0
2019-09-25,1.1,469536,517903,987439,0,0,0
2019-09-26,1.02,354259,361739,715998,0,0,0
2019-09-27,1.03,647689,665684,1313373,0,0,0
2019-09-30,1.19,330259,394118,724377,0,0,0
2019-10-01,0.97,564206,548285,1112491,0,0,0
2019-10-02,1.73,659613,1142294,1801907,0,0,0
2019-10-03,2.01,480871,965745,1446616,0,0,0
2019-10-04,1.08,474302,511372,985674,0,0,0
2019-10-08,1.39,389944,541503,931447,38657488,57493326,96150814
2019-10-09,1.23,280307,346082,626389,39913477,58537304,98450781
2019-10-10,1.14,314853,359974,674827,40505339,58971707,99477046
2019-10-11,0.83,849454,702128,1551582,41398117,60024809,101422926
2019-10-14,1.44,254457,366520,620977,40991008,59302141,100293149
2019-10-15,0.98,484397,476542,960939,41232978,59504609,100737587
2019-10-16,0.74,371014,275759,646773,42126349,60728703,102855052
2019-10-17,1.2,443697,530341,974038,42956671,61171128,104127799
2019-10-18,2.13,415466,883131,1298597,43515145,62233185,105748330
2019-10-21,1.16,296303,344456,640759,34939751,51619897,86559648
2019-10-22,1.39,327529,453949,781478,35691651,52356542,88048193
2019-10-23,0.94,328934,308037,636971,36620083,53566310,90186393
2019-10-24,0.75,425948,319337,745285,37081379,54072238,91153617
2019-10-25,1.1,517193,568848,1086041,37968220,54927367,92895587
2019-10-28,0.65,409804,265545,675349,37186613,53889523,91076136
2019-10-29,1.01,361463,363759,725222,38110625,54806218,92916843
2019-10-30,1.37,416165,570779,986944,38746702,56064736,94811438
2019-10-31,2.16,414109,894292,1308401,39459975,57127042,96587017
2019-11-01,0.76,654750,499380,1154130,40296524,58149889,98446413
2019-11-04,0.72,808863,580824,1389687,39696748,56984775,96681523
2019-11-05,1.37,394299,539627,933926,40647464,57943696,98591160
2019-11-06,1.15,433647,497129,930776,41441366,59122955,100564321
2019-11-07,0.71,669907,473216,1143123,41900530,59603991,101504521
2019-11-08,1.4,370663,518357,889020,42784568,60728354,103512922
2019-11-11,1.04,330543,342325,672868,42330828,60427941,102758769
2019-11-12,1.26,383645,483406,867051,42771758,61070311,103842069
2019-11-13,1.68,284576,478947,763523,43229153,61983692,105212845
2019-11-14,2.16,313438,676024,989462,43411907,62506720,105918627
2019-11-15,1.32,461999,608777,1070776,44008545,64040650,108049195
2019-11-18,1.2,315779,378055,693834,37055109,53484147,90539256
2019-11-19,1.32,339891,448461,788352,37694060,54158015,91852075
2019-11-20,1.39,354247,492007,846254,38510372,55552832,94063204
2019-11-21,1.97,285759,562666,848425,39262489,56387013,95649502
2019-11-22,1.02,340803,349274,690077,39861812,57438425,97300237
2019-11-25,1.24,411071,509903,920974,39310865,56359147,95670012
2019-11-26,2.37,345907,821090,1166997,40279014,57086068,97365082
2019-11-27,1.83,317211,579260,896471,40990619,58415610,99406229
2019-11-29,1.15,218975,251216,470191,41478260,59107278,100585538
2019-12-02,0.92,452669,415558,868227,40152382,57409068,97561450
2019-12-03,1.58,432292,684976,1117268,40982294,58150733,99133027
2019-12-04,1.26,312720,395362,708082,41730096,59363041,101093137
2019-12-05,1.63,205355,334748,540103,42170845,60046229,102217074
2019-12-06,1.14,490275,556716,1046991,42663612,60988441,103652053
2019-12-09,1.06,316074,334460,650534,41740970,60073046,101814016
2019-12-10,0.83,272873,227059,499932,42266242,60805902,103072144
2019-12-11,1.33,362538,480694,843232,42907428,61713061,104620489
2019-12-12,0.72,985461,710286,1695747,43492235,62542742,106034977
2019-12-13,0.89,604164,540495,1144659,44984288,63883752,108868040
2019-12-16,0.91,508434,465000,973434,41116392,62602937,103719329
2019-12-17,0.71,428227,303794,732021,38278518,56744476,95022994
2019-12-18,2.56,343869,881479,1225348,42277074,63825030,106102104
2019-12-19,0.95,593210,562149,1155359,42573921,64651009,107224930
2019-12-20,1.33,478876,635118,1113994,39320227,66090582,105410809
2019-12-23,0.98,351769,343566,695335,31988600,49227375,81215975
2019-12-24,0.71,233296,166042,399338,32931453,49994597,82926050
2019-12-26,1.1,302540,333503,636043,33344281,50520274,83864555
2019-12-27,0.91,459229,417388,876617,34100324,51427036,85527360
2019-12-30,0.94,478014,451118,929132,33552094,49978785,83530879
2019-12-31,1.22,314841,383615,698456,34991982,51835748,86827730
2020-01-02,0.99,475427,468474,943901,34219304,49772111,83991415
2020-01-03,0.75,596901,447640,1044541,35192009,51032230,86224239
2020-01-06,0.78,445902,348300,794202,34942867,51028277,85971144
2020-01-07,1.66,328263,544222,872485,35604392,51918291,87522683
2020-01-08,1.06,593823,626855,1220678,36328430,53000689,89329119
2020-01-09,0.71,552252,393481,945733,37239491,54238733,91478224
2020-01-10,0.92,552000,505676,1057676,38229822,55609994,93839816
2020-01-13,1.09,429886,470189,900075,37742917,55184230,92927147
2020-01-14,1.0,397807,396943,794750,38495963,56902956,95398919
2020-01-15,0.95,471433,446672,918105,39234127,58108354,97342481
2020-01-16,0.99,602238,597791,1200029,40102891,59199930,99302821
2020-01-17,0.93,615383,575108,1190491,40740672,61396034,102136706
2020-01-21,0.91,430568,390915,821483,27558589,40221363,67779952
2020-01-22,1.11,365166,404892,770058,28552343,41951549,70503892
2020-01-23,0.86,526350,453154,979504,29172519,43128332,72300851
2020-01-24,1.29,684897,884808,1569705,30654266,44452629,75106895
2020-01-27,1.19,666867,796229,1463096,30319583,44754002,75073585
2020-01-28,1.05,465447,489748,955195,31713033,46366082,78079115
2020-01-29,1.26,351417,442451,793868,32874786,47622049,80496835
2020-01-30,0.99,533259,529418,1062677,33353131,48441444,81794575
2020-01-31,1.46,921134,1341796,2262930,34818030,49908843,84726873
2020-02-03,0.62,791065,493923,1284988,33997092,48936806,82933898
2020-02-04,1.15,533577,613067,1146644,35006276,49668306,84674582
2020-02-05,1.77,531447,940080,1471527,35825743,50805655,86631398
2020-02-06,1.07,430806,461228,892034,36637831,51802405,88440236
2020-02-07,1.6,447646,717438,1165084,37371856,53113389,90485245
2020-02-10,1.25,443013,555218,998231,36262711,52020710,88283421
2020-02-11,0.95,665452,631617,1297069,37049157,52691130,89740287
2020-02-12,0.74,686914,511581,1198495,38252014,53700865,91952879
2020-02-13,0.95,476919,453340,930259,39049911,54835576,93885487
2020-02-14,1.14,392932,446319,839251,39907322,55923723,95831045
2020-02-18,0.84,575047,485424,1060471,38751963,54679094,93431057
2020-02-19,0.92,448536,410998,859534,39470215,55445099,94915314
2020-02-20,1.11,584155,647658,1231813,40080179,56186138,96266317
2020-02-21,1.45,705496,1026036,1731532,41023927,57635213,98659140
2020-02-24,1.47,975490,1434363,2409853,33707568,47763979,81471547
2020-02-25,1.99,974034,1938514,2912548,35597372,49887947,85485319
2020-02-26,1.75,637452,1118599,1756051,37836864,52558100,90394964
2020-02-27,1.48,986033,1456720,2442753,38963487,53661539,92625026
2020-02-28,1.33,1047201,1388379,2435580,41357966,56268347,97626313
2020-03-02,1.32,673405,888416,1561821,40798234,56085109,96883343
2020-03-03,1.12,755989,850126,1606115,41866201,57300983,99167184
2020-03-04,2.6,560559,1459139,2019698,43381573,59130655,102512228
2020-03-05,1.1,757871,836838,1594709,44154790,60322937,104477727
2020-03-06,1.1,1114201,1229146,2343347,45253070,62298967,107552037
2020-03-09,1.79,663088,1184136,1847224,44426586,61117770,105544356
2020-03-10,1.05,746169,781619,1527788,45819383,61924802,107744185
2020-03-11,1.23,779663,962415,1742078,47358889,63592180,110951069
2020-03-12,1.79,809600,1445159,2254759,48480327,65225147,113705474
2020-03-13,1.4,773271,1080029,1853300,50871479,66047536,116919015
2020-03-16,1.53,687110,1053985,1741095,49796238,65697633,115493871
2020-03-17,1.35,549419,739286,1288705,50965511,66166414,117131925
2020-03-18,1.3,751992,978455,1730447,52376008,67273792,119649800
2020-03-19,1.08,693862,751587,1445449,53627724,67926729,121554453
2020-03-20,1.42,695103,989740,1684843,55275133,69052171,124327304
2020-03-23,1.07,809719,863650,1673369,40473133,53881719,94354852
2020-03-24,1.02,799745,812728,1612473,41802899,54624630,96427529
2020-03-25,1.25,788796,983646,1772442,43353372,56340238,99693610
2020-03-26,1.31,708732,926124,1634856,44343288,57239551,101582839
2020-03-27,1.29,676929,874238,1551167,45537009,59167783,104704792
2020-03-30,1.21,659556,799479,1459035,43616371,56010861,99627232
2020-03-31,1.35,666210,900234,1566444,45932864,58604568,104537432
2020-04-01,1.31,674403,880302,1554705,44594425,58227939,102822364
2020-04-02,1.51,549884,830587,1380471,45500354,58717355,104217709
2020-04-03,1.13,781173,883603,1664776,46343962,60556604,106900566
2020-04-06,1.07,818325,876593,1694918,45538324,59598563,105136887
2020-04-07,1.16,816441,949054,1765495,46724058,60573458,107297516
2020-04-08,1.16,723874,838615,1562489,47896976,62093814,109990790
2020-04-09,1.22,1025732,1246583,2272315,48650232,63174731,111824963
2020-04-13,1.02,654957,669230,1324187,48607925,63228962,111836887
2020-04-14,1.15,720224,829228,1549452,49741957,63750344,113492301
2020-04-15,1.38,540806,748857,1289663,50752727,65350558,116103285
2020-04-16,1.25,536087,667495,1203582,52303979,66301926,118605905
2020-04-17,1.22,794302,968178,1762480,53527212,67655458,121182670
2020-04-20,1.07,739200,790583,1529783,41890472,52910024,94800496
2020-04-21,1.45,681311,985826,1667137,43097685,54224513,97322198
2020-04-22,1.06,574241,610747,1184988,45454121,56160071,101614192
2020-04-23,1.13,559006,630444,1189450,45816752,56759711,102576463
2020-04-24,1.35,594741,801668,1396409,47523312,57895873,105419185
2020-04-27,1.36,494552,670818,1165370,46729243,56306515,103035758
2020-04-28,1.31,500224,653870,1154094,47528850,57597747,105126597
2020-04-29,1.54,711509,1097464,1808973,42553495,55856286,98409781
2020-04-30,1.24,565738,700458,1266196,48996357,60004608,109000965
2020-05-01,1.42,654862,927185,1582047,49935752,61097594,111033346
2020-05-04,1.26,470122,590664,1060786,48583099,59213564,107796663
2020-05-05,1.04,470028,487469,957497,49323545,59880110,109203655
2020-05-06,1.0,479426,479205,958631,50121670,61165523,111287193
2020-05-07,1.14,436212,498581,934793,50699757,61641526,112341283
2020-05-08,1.18,567852,671894,1239746,51698337,62930988,114629325
2020-05-11,1.12,433692,485496,919188,51204871,62158732,113363603
2020-05-12,1.17,468260,547568,1015828,51688184,62903645,114591829
2020-05-13,1.61,691170,1113651,1804821,52693833,64167221,116861054
2020-05-14,1.25,612657,763751,1376408,53150638,64707633,117858271
2020-05-15,1.15,794217,915377,1709594,54010545,65791216,119801761
2020-05-18,0.94,726274,680279,1406553,45281353,53401836,98683189
2020-05-19,1.0,541523,543208,1084731,46549796,54856162,101405958
2020-05-20,1.19,508428,605392,1113820,47690715,55756703,103447418
2020-05-21,1.1,467247,513185,980432,48461511,57082359,105543870
2020-05-22,1.1,483113,530871,1013984,49335107,58607522,107942629
2020-05-26,1.26,579303,730731,1310034,48333942,56999739,105333681
2020-05-27,1.34,580651,777556,1358207,48907942,58474100,107382042
2020-05-28,1.33,548750,727771,1276521,49462735,59747477,109210212
2020-05-29,1.2,704813,848618,1553431,50448184,61163897,111612081
2020-06-01,1.49,374136,557982,932118,49103466,59288720,108392186
2020-06-02,1.18,460674,541773,1002447,49674746,59854007,109528753
2020-06-03,1.04,745077,773781,1518858,50754806,60936436,111691242
2020-06-04,1.25,520344,648954,1169298,51593753,62274575,113868328
2020-06-05,0.85,1101200,938141,2039341,52187558,63958139,116145697
2020-06-08,0.89,617603,549386,1166989,52107485,63520047,115627532
2020-06-09,0.9,525913,474947,1000860,53065008,64431661,117496669
2020-06-10,0.91,680531,621694,1302225,54079688,65582632,119662320
2020-06-11,1.22,1090028,1324717,2414745,54988685,66548529,121537214
2020-06-12,1.35,846251,1140795,1987046,56533081,67711639,124244720
2020-06-15,1.15,705498,814510,1520008,54411841,66418830,120830671
2020-06-16,1.0,627261,630130,1257391,55308128,66955003,122263131
2020-06-17,0.86,540523,467044,1007567,56073239,68221801,124295040
2020-06-18,1.23,370615,454872,825487,56128662,68537566,124666228
2020-06-19,1.2,674126,808734,1482860,55413257,69694030,125107287
2020-06-22,0.94,497050,469054,966104,42241766,49701288,91943054
2020-06-23,1.29,352995,454924,807919,43151624,50574333,93725957
2020-06-24,1.41,571562,805665,1377227,43969545,51717980,95687525
2020-06-25,1.15,435672,503068,938740,44789509,52813930,97603439
2020-06-26,1.25,565525,707950,1273475,45676852,53916960,99593812
2020-06-29,1.12,397275,444983,842258,44848554,53083537,97932091
2020-06-30,1.06,567693,599982,1167675,45447285,53685697,99132982
2020-07-01,0.9,494103,445730,939833,44727888,52792198,97520086
2020-07-02,1.0,531561,532585,1064146,45376903,53462481,98839384
2020-07-06,1.18,387677,457607,845284,44754362,52990403,97744765
2020-07-07,1.13,375245,423515,798760,45731770,53942430,99674200
2020-07-08,1.08,442160,477249,919409,46662857,54889092,101551949
2020-07-09,1.24,534071,659900,1193971,47363800,55608716,102972516
2020-07-10,1.13,489617,551893,1041510,48407183,56770256,105177439
2020-07-11,0.92,526803,484323,1011126,51228751,59468479,110697230
2020-07-13,0.91,723013,656030,1379043,47768526,55983384,103751910
2020-07-14,1.66,454873,756614,1211487,49099879,57004187,106104066
2020-07-15,0.82,599665,492151,1091816,49789732,58046731,107836463
2020-07-16,0.84,449221,378161,827382,50487475,58763892,109251367
2020-07-17,0.92,526803,484323,1011126,51228751,59468479,110697230
2020-07-20,0.96,464937,444456,909393,42133925,47566674,89700599
2020-07-21,0.79,597521,470544,1068065,43103952,48676013,91779965
2020-07-22,0.79,562444,444950,1007394,44162475,50099132,94261607
2020-07-23,0.85,649707,554573,1204280,45142436,50924808,96067244
2020-07-24,1.16,550815,637037,1187852,46217778,52171340,98389118
2020-07-27,0.69,603277,416522,1019799,45080504,51401612,96482116
2020-07-28,1.16,450265,523332,973597,46030802,52499366,98530168
2020-07-29,0.84,452287,380629,832916,47032936,53931484,100964420
2020-07-30,0.92,516273,473347,989620,47604368,54662647,102267015
2020-07-31,0.98,643624,627610,1271234,48453849,55764906,104218755
2020-08-03,0.88,491480,434930,926410,46960643,53988295,100948938
2020-08-04,1.41,469204,662653,1131857,47665213,54792503,102457716
2020-08-05,0.94,708553,663819,1372372,48594292,56212318,104806610
2020-08-06,0.75,603309,454181,1057490,49253447,57128654,106382101
2020-08-07,0.85,671206,568521,1239727,50398082,58275420,108673502
2020-08-10,0.76,539624,409182,948806,49794914,57659172,107454086
2020-08-11,0.84,777440,653843,1431283,50670186,58514429,109184615
2020-08-12,0.95,478443,452391,930834,51961160,59842488,111803648
2020-08-13,0.68,599688,408310,1007998,52608370,60633073,113241443
2020-08-14,0.89,444279,393438,837717,53583579,61818190,115401769
2020-08-17,0.81,381382,309562,690944,52590215,60919637,113509852
2020-08-18,0.89,417055,372896,789951,52650533,61513208,114163741
2020-08-19,1.16,414213,479721,893934,53870508,63502582,117373090
2020-08-20,1.09,441037,482108,923145,54305954,64415529,118721483
2020-08-24,0.97,382453,369642,752095,48341282,55589245,103930527
2020-08-25,0.58,485858,280964,766822,49177570,56326676,105504246
2020-08-26,0.84,488376,408475,896851,50194232,57507834,107702066
2020-08-27,0.88,510729,448862,959591,51044674,58576800,109621474
2020-08-28,0.68,560624,378942,939566,51849324,59809771,111659095
2020-08-31,0.99,414709,411622,826331,50680374,58449487,109129861
2020-09-01,0.98,421139,413052,834191,51417922,59163957,110581879
2020-09-02,1.19,502967,599532,1102499,52205638,60351156,112556794
2020-09-03,1.68,744907,1249542,1994449,53017759,61388559,114406318
2020-09-04,1.35,773791,1048042,1821833,54302302,62619321,116921623
2020-09-08,1.04,627466,652195,1279661,53433214,61461590,114894804
2020-09-09,1.05,435181,456658,891839,54230376,62102511,116332887
2020-09-10,1.13,511388,578294,1089682,54786519,62930110,117716629
2020-09-11,1.35,479406,647219,1126625,55679460,63867099,119546559
2020-09-14,0.95,429162,407226,836388,54521450,63005541,117526991
2020-09-15,0.92,365929,335133,701062,55210038,63704739,118914777
2020-09-16,1.05,505936,529613,1035549,55881410,64548665,120430075
2020-09-17,1.17,543152,635324,1178476,56311980,65102726,121414706
2020-09-18,1.21,650899,786470,1437369,55828594,66047884,121876478
2020-09-21,1.25,650262,815779,1466041,45458063,51213770,96671833
2020-09-22,1.0,358343,359833,718176,46452381,52485783,98938164
2020-09-23,1.27,589431,749294,1338725,47159097,53717799,100876896
2020-09-24,1.26,495727,624086,1119813,47938592,54787821,102726413
2020-09-25,0.89,606287,540935,1147222,48894839,55807433,104702272
2020-09-28,0.87,394196,341458,735654,47559169,54952091,102511260
2020-09-29,1.04,328860,342964,671824,48255217,55879794,104135011
2020-09-30,1.14,461169,525455,986624,48982606,56814676,105797282
2020-10-01,1.04,422113,439915,862028,47132939,55377670,102510609
2020-10-02,1.07,539550,575441,1114991,47991063,56326764,104317827
2020-10-05,0.88,472469,418013,890482,47361855,55670718,103032573
2020-10-06,1.14,571451,650591,1222042,48076023,56241043,104317066
2020-10-07,0.89,428212,380107,808319,49027634,57480328,106507962
2020-10-08,1.02,456838,465041,921879,49589157,58417035,108006192
2020-10-09,0.87,722777,625360,1348137,50443400,59552790,109996190
2020-10-12,0.86,587043,505155,1092198,49873355,58697727,108571082
2020-10-13,0.99,328204,326069,654273,50604728,59955301,110560029
2020-10-14,1.03,411951,424824,836775,51272691,61062558,112335249
2020-10-15,0.93,493694,458535,952229,51662680,61430751,113093431
2020-10-16,1.01,553092,560416,1113508,52495474,62548887,115044361
2020-10-19,1.19,399542,473661,873203,43869679,51536757,95406436
2020-10-20,0.87,410722,358027,768749,44652278,52328133,96980411
2020-10-21,1.19,353426,421813,775239,45594598,53299467,98894065
2020-10-22,1.18,354330,416385,770715,46161489,53830194,99991683
2020-10-23,0.92,375408,346710,722118,46928298,54917256,101845554
2020-10-26,1.31,520892,681668,1202560,46136113,54157853,100293966
2020-10-27,1.04,310841,323075,633916,46933723,55313260,102246983
2020-10-28,1.53,607243,927332,1534575,47723832,56505300,104229132
2020-10-29,1.26,483915,610767,1094682,48679709,57595946,106275655
2020-10-30,1.39,701156,977163,1678319,49598367,58612656,108211023
2020-11-02,1.08,500577,542297,1042874,47851965,56796130,104648095
2020-11-03,1.72,570751,978922,1549673,48931751,57869625,106801376
2020-11-04,1.22,719224,879418,1598642,50233975,59651460,109885435
2020-11-05,0.96,714062,686071,1400133,50755083,60351395,111106478
2020-11-06,1.0,620753,619113,1239866,51794500,62089407,113883907
2020-11-09,0.99,881209,875639,1756848,50925038,60443390,111368428
2020-11-10,1.0,605260,606335,1211595,51748314,61749734,113498048
2020-11-11,2.0,447647,894191,1341838,52481588,62712492,115194080
2020-11-12,1.34,515729,690652,1206381,52824544,63802482,116627026
2020-11-13,1.05,655731,691350,1347081,53443031,65281882,118724913
2020-11-16,0.92,628613,575690,1204303,52740766,64050159,116790925
2020-11-17,1.32,427231,565956,993187,53345212,65038001,118383213
2020-11-19,1.36,497796,675907,1173703,55167494,67007149,122174643
2020-11-20,0.97,618286,598240,1216526,55893300,68254439,124147739
2020-11-24,0.93,655103,608298,1263401,49072889,56511533,105584422
2020-11-25,0.98,495244,483377,978621,50285724,58114003,108399727
2020-11-27,0.84,407966,344434,752400,50902608,58842153,109744761
2020-12-01,1.0,575087,573675,1148762,50502309,58231039,108733348
2020-12-02,0.91,563199,512433,1075632,51363953,59447031,110810984
2020-12-03,1.09,494280,539093,1033373,52158361,60379521,112537882
2020-12-04,0.89,631141,564233,1195374,53281692,61589202,114870894
2020-12-07,0.94,504845,475773,980618,52981024,60843750,113824774
2020-12-08,1.0,407671,409690,817361,53872256,61789591,115661847
2020-12-09,1.32,618442,814027,1432469,54885337,62834426,117719763
2020-12-10,1.21,419109,508208,927317,55469141,64185798,119654939
2020-12-11,1.4,607887,851914,1459801,56042751,65311230,121353981
2020-12-15,1.28,479271,613544,1092815,52827602,65560837,118388439
2020-12-16,0.89,562556,501555,1064111,53706788,66931731,120638519
2020-12-17,0.96,564539,543866,1108405,53907986,67654472,121562458
2020-12-18,0.94,760043,713578,1473621,52332564,69104555,121437119
2020-12-28,1.16,453239,526138,979377,45686161,53855413,99541574
2020-12-29,1.27,448376,568571,1016947,45985216,54549331,100534547
